Lane,SampleID,Index,# Reads,# Perfect Index Reads,# One Mismatch Index Reads,# of >= Q30 Bases (PF),Mean Quality Score (PF)
1,ACC7880A64,TCAAGTTCCT-CAAGTTCTAG,5597315,5458677,138638,1583164231,35.91
1,ACC7880A83,TCGTGGCTAG-GCCAGCAGTA,6105046,5970225,134821,1705728066,35.67
1,ACC7880A65,AGACCTAGCT-CACAAGTATC,5727112,5615337,111775,1624214959,35.97
1,ACC7880A71,CTGCGTACTC-CTGATGGCAA,6403709,6286195,117514,1804026638,35.83
1,ACC7880A78,CGCAGAACTT-TATCGACGTC,6573564,6434424,139140,1861825116,35.94
1,ACC7880A16,TCGCTTAAGC-CTAGGCGTGT,6066678,5989574,77104,1707241579,35.81
1,ACC7880A70,TTCACACAGT-CTTCAGTGTT,4545611,4475767,69844,1283934042,35.89
1,ACC7880A36,GCTGCCGATA-TATCCTACGT,5062940,4994758,68182,1436776911,35.97
1,ACC7880A72,TGGATATGGC-TGGCGCGTAT,9425479,9279338,146141,2633267669,35.68
1,ACC7880A84,AGGACTGAAC-TGAAGCGACG,7572582,7455031,117551,2136578875,35.87
1,ACC7880A27,TTAGGAGGAA-GAACTTGCGT,5883691,5730122,153569,1638182654,35.62
1,ACC7880A51,GAGCATCCAT-TCACGTCCAC,2292199,2258896,33303,646804831,35.86
1,ACC7880A76,AATGTGGCGT-TGTCAGGTAG,5375408,5290350,85058,1521419634,35.93
1,ACC7880A10,CTAGTCAGAA-TTGAATGCTG,6044050,5939054,104996,1695302674,35.75
1,ACC7880A85,GCTGAGAGCT-GTGATAGGTG,6007374,5820664,186710,1688363298,35.79
1,ACC7880A77,GCTACTGTCG-CTTGCTCCAT,3269412,3205355,64057,910661885,35.61
1,ACC7880A17,AAGACAGCTT-TCGCTGACCT,8354351,8222826,131525,2339347972,35.71
1,ACC7880A80,GTTCCACCGA-CCTGCTGTTA,5502474,5402850,99624,1497524541,35.05
1,ACC7880A59,CGGAACGAAG-ACCATCGCCT,7378110,7209959,168151,2083559270,35.87
1,ACC7880A49,GACGAACGTA-TCGTCCTTCA,7125069,7018492,106577,1949527945,35.27
1,ACC7880A24,GACAATAGAG-TAGTGTACAC,6525691,4100210,2425481,1782711029,35.24
1,ACC7880A63,TCAGCACCGT-ACTGAATAGG,6023109,5923044,100065,1683524050,35.67
1,ACC7880A25,AGACGGCATC-AAGGTAACCT,5731742,5622409,109333,1590380248,35.55
1,ACC7880A87,AATGGTACTG-ACAGCAGTTA,6582275,6455779,126496,1825520943,35.53
1,ACC7880A23,TGCCACTGTA-CAGCAGGTCA,5447306,5348057,99249,1510353479,35.53
1,ACC7880A20,AGCTATCTTC-GTGTCGCTAG,6147861,6016196,131665,1730855881,35.82
1,ACC7880A39,ATACCTGTGA-GCATTGTGCT,3464059,3404340,59719,953355693,35.37
1,ACC7880A33,TTGGCCAGTT-ATGCTACCTG,6934365,6780343,154022,1954878623,35.84
1,ACC7880A9,CGATGAGACT-TTAGTCGTGC,5091726,5002759,88967,1429284958,35.76
1,ACC7880A41,AGAGATGGTA-GCTTACGGAA,2347148,984541,1362607,655525171,35.66
1,ACC7880A67,GCCTAGGACT-GAGAACGGCT,6096137,5986361,109776,1724848361,35.92
1,ACC7880A28,ACAGAAGGTT-TGGAGATATC,6773767,6678997,94770,1917383078,35.93
1,ACC7880A57,ACGCGGACTT-TATTGCCTCG,8543921,8391689,152232,2424420285,35.98
1,ACC7880A32,AACGACGCAT-AACTACAACG,9509890,9377538,132352,2683031197,35.84
1,ACC7880A40,TCAGATTCAC-TGGAGTGCGA,2586341,2530476,55865,725841372,35.76
1,ACC7880A48,CCGACTCCTT-ACTGTCCTTG,1946814,1868725,78089,547528473,35.80
1,ACC7880A44,TCACCGTCAC-CAACTCCTTA,9380156,9222375,157781,2652889219,35.90
1,ACC7880A56,CTATAGCGAG-AGTCGACTAG,6192638,6042286,150352,1744696818,35.84
1,ACC7880A89,TCACCAGGAC-TCCTTGTCTC,8337000,8223106,113894,2334987955,35.70
1,ACC7880A11,CGATAGCAGG-TCGTAGCATT,4895407,4824040,71367,1350580768,35.41
1,ACC7880A68,TTCCACCTGG-ATGAGCTTCT,7335682,7207531,128151,1992123347,35.11
1,ACC7880A3,TGTGAGCGAA-GATCGGAGTT,4860865,4792231,68634,1340549338,35.42
1,ACC7880A74,CTCTCATGCG-ACGTCGGTTG,6375197,6248650,126547,1745647982,35.27
1,ACC7880A18,TATCACTCTC-ACCTTGTTCT,6756826,6363654,393172,1865092018,35.46
1,ACC7880A46,GTGTTATCTC-ACACCAGACT,7852812,7470700,382112,2192845845,35.67
1,ACC7880A38,CTATACACCA-CCAACTACGG,4074930,3991540,83390,1097813032,34.88
1,ACC7880A30,TTCAGGTCGT-TTGGTTGGTT,8154874,8020400,134474,2276196478,35.66
1,ACC7880A22,AGAGGAATCG-CCAGACTATC,5404095,5288722,115373,1497766740,35.52
1,ACC7880A26,ACTGGTGTCG-CAAGTCCTGT,7356797,7215312,141485,2061873556,35.73
1,ACC7880A29,GAGAGCTAAC-CAATACTTGC,6968086,6865090,102996,1958931204,35.79
1,ACC7880A50,CCACTGTGAC-TGGACAGATG,7945273,7803178,142095,2224081785,35.71
1,ACC7880A8,AATCTCAGGC-TCTCTAACTC,2071901,2036709,35192,579732332,35.69
1,ACC7880A58,AGAATCCTTC-TGCCAGGTGT,3742206,3559510,182696,1055791375,35.87
1,ACC7880A21,AGGTGGCTAC-CCACGTAACG,6957104,6857830,99274,1962339619,35.85
1,ACC7880A75,CAACCGATTA-TGCTGAGTTA,6086451,5914941,171510,1704429758,35.72
1,ACC7880A69,TTATCTGTGC-CACTCAGTAT,4688931,4616328,72603,1312127255,35.69
1,ACC7880A90,TAATCTACGG-CTGGCACTTA,6689522,6574420,115102,1865079071,35.63
1,ACC7880A82,GAGCTCCACA-CAGAACAGAA,2878595,2817137,61458,773098832,34.79
1,ACC7880A52,GTTATTAGGC-CTCGATGAAC,3981043,3879134,101909,1117720821,35.77
1,ACC7880A47,AACACAGCCG-AGACCTTGGT,4931944,4841385,90559,1360774219,35.41
1,ACC7880A54,CGCTTAAGTA-ATTACTGCAC,7049126,6933039,116087,1962492911,35.60
1,ACC7880A62,CACGGTTGGT-CTAGCTGAAT,5935484,5825902,109582,1656113317,35.64
1,ACC7880A81,GACGTTCTCT-AGTAGAGCTA,6660430,6490783,169647,1877151482,35.84
1,ACC7880A5,AACAACCTCA-TTGGACTAAG,1222215,1193998,28217,335944496,35.35
1,ACC7880A31,CTTGTCTTGC-AACCAATGTG,5241091,5147430,93661,1463841485,35.67
1,ACC7880A4,GATGAAGGAT-GAATAAGGCT,1362375,1344028,18347,383490222,35.80
1,ACC7880A66,GCCTTACTTA-GCACCTTAAC,5153901,5060681,93220,1452654997,35.84
1,ACC7880A34,ATTGCGGCTG-TGTCCTACAA,6669736,6518619,151117,1873789838,35.76
1,ACC7880A12,TATGGTGATG-TTCAAGTAGC,7605162,7458571,146591,2142739638,35.83
1,ACC7880A14,CCGGTTCATG-AGACGTCTTG,1565639,1518639,47000,430656265,35.40
1,ACC7880A60,TATCGTTGTG-TGTGTCCGCA,6943740,6791577,152163,1957052034,35.84
1,ACC7880A19,GCTGCTAACA-AGCTCTTGTG,4781686,4676944,104742,1340954193,35.75
1,ACC7880A7,ACCGACGTGA-AACGGTCATG,5816608,5714424,102184,1558230668,34.82
1,ACC7880A88,CAGCCTTGAG-TGAGTAGCAT,6051958,4224590,1827368,1677652184,35.51
1,ACC7880A37,GAATGTCCAA-GAATACCGTA,6815724,6663976,151748,1910730574,35.73
1,ACC7880A13,GTTGGACGGT-AGGACACTGT,4414188,4341416,72772,1233673321,35.68
1,ACC7880A45,TGTGAAGCTA-ACGCGATTCA,6232388,6125248,107140,1722857285,35.47
1,ACC7880A53,TTATCGCTGA-TTAGGATTGG,8022304,7887419,134885,2169875957,35.02
1,ACC7880A1,ATTCCACACT-TGGTCTTGTT,4085932,4010059,75873,1133878354,35.56
1,ACC7880A55,TTACGGAACA-TGACTCTGTC,2721527,2678276,43251,760281606,35.67
1,ACC7880A2,TACTAGAGGA-GAACCGGTCT,4378444,4306122,72322,1169217906,34.69
1,ACC7880A61,AACACAACGA-ACGCAGCCAA,7480319,7322847,157472,2032858632,35.02
1,ACC7880A79,CCAAGACACT-ACCGACATGG,2393637,2322124,71513,665931773,35.59
1,ACC7880A86,GAGCTTATGA-ACCAGTCATT,7197153,7092324,104829,1976821828,35.27
1,ACC7880A42,ATGGAGACGG-CTGAGAGTTC,6920952,6813690,107262,1913534117,35.47
1,ACC7880A43,GTGTACGTCG-TCCTAGCAGG,5637756,5545000,92756,1591584308,35.87
1,ACC7880A35,AGAGACTTAC-TAAGAGTTGG,4719289,4640733,78556,1334584657,35.91
1,ACC7880A6,AGATCTTCCA-GTGTTGATCT,2837264,2783711,53553,748031475,34.51
1,ACC7880A15,TTGGCCATAC-GCCTAGTGCA,6691540,6586533,105007,1885951785,35.84
1,ACC7880A73,TATAACTCCG-TATGTGTCCT,6493158,6382337,110821,1817061785,35.70
1,ACC7804A22,GGTCACGAAT-CATAATACGT,37191530,36621936,569594,10315300914,35.57
1,ACC7804A13,AGTACTCCAT-AACAGGTTGT,57038824,55608765,1430059,15829393072,35.58
1,ACC7809A1,TATCGCACAT-ACACTAAGGT,25250768,24481688,769080,6872877807,35.21
1,ACC7795A1,CAACAATGAT-CCGTGAAGGT,292983565,287660230,5323335,81182104118,35.55
1,ACC7804A15,TGCGAGACAT-CAACAATGGT,27977251,27449103,528148,7764917641,35.58
1,ACC7809A2,CGCTATGTAT-GTGTCGGAGT,33077403,31794645,1282758,8913500481,35.02
1,ACC7795A2,TGGTGGCAAT-TTACAGGAGT,118665426,116404036,2261390,32796712008,35.51
1,ACC7804A18,GTATGTTCAT-TTCCTGTTGT,17640118,16915357,724761,4793424809,35.20
1,ACC7807A1,ACGCACCTAT-CCTTCACCGT,18387518,17836115,551403,4959029638,35.07
1,ACC7866A1,CCGCGGTTAT-CTAGCGCTGT,139234280,134836095,4398185,38687521885,35.61
1,ACC7866A9,AGTTCAGGAT-TCTGTTGGGT,96071876,93544359,2527517,26560733843,35.52
1,ACC7872A3,TAATACAGAT-GTGAATATGT,101941117,99290170,2650947,28255917865,35.56
1,ACC7866A2,TTATAACCAT-TCGATATCGT,91174008,89459146,1714862,25275175603,35.56
1,ACC7872A4,CGGCGTGAAT-ACAGGCGCGT,95171973,92722836,2449137,26399998294,35.58
1,ACC7866A3,GGACTTGGAT-CGTCTGCGGT,74206365,72850838,1355527,20583668026,35.58
1,ACC7804A17,TCTCTACTAT-GAACCGCGGT,81473766,70265626,11208140,22472602717,35.47
1,ACC7872A5,ATGTAAGTAT-CATAGAGTGT,104586235,102219169,2367066,28895667002,35.51
1,ACC7866A4,AAGTCCAAAT-TACTCATAGT,99257358,97180777,2076581,27528662446,35.57
1,ACC7872A6,GCACGGACAT-TGCGAGACGT,91902958,89994929,1908029,25509441741,35.59
1,ACC7866A5,ATCCACTGAT-ACGCACCTGT,93725026,91302527,2422499,25924172327,35.52
1,ACC7872A7,GGTACCTTAT-GACGTCTTGT,129428515,125855189,3573326,35945290962,35.59
1,ACC7866A6,GCTTGTCAAT-GTATGTTCGT,81754503,79297051,2457452,22673012169,35.57
1,ACC7872A8,AACGTTCCAT-AGTACTCCGT,85328975,83173897,2155078,23706536912,35.60
1,ACC7866A7,CAAGCTAGAT-CGCTATGTGT,93651630,91367385,2284245,25987161841,35.58
1,ACC7872A9,GCAGAATTAT-TGGCCGGTGT,110452259,108334199,2118060,30701803403,35.61
1,ACC7866A8,TGGATCGAAT-TATCGCACGT,82328972,80535986,1792986,22878764379,35.61
1,ACC7872A2,AATCCGGAAT-AACTGTAGGT,87357707,84199402,3158305,23829297261,35.29
1,C07---UDI0051,AACAGGTTAT-CTTGGTATGT,902,879,23,247671,35.41
1,H06---UDI0048,ACCTTGGCAT-ATGAGGCCGT,647,612,35,178234,35.45
1,B07---UDI0050,GCGCTCTAAT-GTCGGAGCGT,686,669,17,188337,35.39
1,G06---UDI0047,GTTCCAATAT-GCAGAATTGT,795,771,24,219825,35.52
1,C06---UDI0043,AAGATACTAT-ATGTAAGTGT,696,669,27,193108,35.59
1,F06---UDI0046,GCAATGCAAT-AACGTTCCGT,631,609,22,174573,35.54
1,A06---UDI0041,ATATGGATAT-TAATACAGGT,936,907,29,259101,35.53
1,G05---UDI0039,TAAGTGGTAT-GGCTTAAGGT,0,0,0,0,0.00
1,F08---UDI0062,TAAGGTCAAT-CTACGACAGT,723,712,11,200800,35.62
1,B06---UDI0042,GCGCAAGCAT-CGGCGTGAGT,608,591,17,168378,35.55
1,H07---UDI0056,GAATGAGAAT-AATGCCTCGT,733,715,18,202998,35.56
1,H10---UDI0080,GTGAATATAT-GAATGAGAGT,0,0,0,0,0.00
1,G07---UDI0055,AGGCAGAGAT-GGCATTCTGT,651,439,212,179438,35.47
1,G08---UDI0063,TTGCCTAGAT-TAAGTGGTGT,697,682,15,194099,35.66
1,B05---UDI0034,CGTTAGAAAT-GACCTGAAGT,737,727,10,203928,35.52
1,E04---UDI0029,CCGTGAAGAT-ATCCACTGGT,46,46,0,12609,35.30
1,D05---UDI0036,GATTCTGCAT-CTCTCGTCGT,3,3,0,861,36.25
1,C05---UDI0035,AGCCTCATAT-TCTCTACTGT,27,27,0,7638,35.98
1,D04---UDI0028,TCCAACGCAT-AAGTCCAAGT,30,30,0,8332,35.64
1,E08---UDI0061,CGGAACTGAT-TCGTAGTGGT,605,587,18,166852,35.49
1,D08---UDI0060,AGCTCGCTAT-GATTCTGCGT,855,803,52,232970,35.27
1,F05---UDI0038,CTACGACAAT-TTGGACTCGT,3,2,1,723,32.94
1,A10---UDI0073,CAATTAACAT-ATATCTCGGT,38,31,7,10384,35.42
1,E06---UDI0045,ATGGCATGAT-GGTACCTTGT,624,598,26,172218,35.49
1,A11---UDI0081,AACTGTAGAT-TGCGGCGTGT,42,41,1,11537,35.43
1,D06---UDI0044,GGAGCGTCAT-GCACGGACGT,654,638,16,180696,35.50
1,B10---UDI0074,TGGCCGGTAT-GCGCTCTAGT,0,0,0,0,0.00
1,E05---UDI0037,TCGTAGTGAT-CCAAGTCTGT,4,4,0,1102,35.25
1,D07---UDI0052,GGTGAACCAT-TCCAACGCGT,0,0,0,0,0.00
1,A09---UDI0065,ACACTAAGAT-ATATGGATGT,1250,1208,42,345523,35.51
1,C09---UDI0067,TTCCTGTTAT-AAGATACTGT,0,0,0,0,0.00
1,E09---UDI0069,GCCACAGGAT-ATGGCATGGT,0,0,0,0,0.00
1,G10---UDI0079,ACAGGCGCAT-AGGCAGAGGT,3,3,0,868,36.40
1,F04---UDI0030,TTACAGGAAT-GCTTGTCAGT,70,68,2,18477,34.76
1,B09---UDI0066,GTGTCGGAAT-GCGCAAGCGT,2,2,0,526,34.50
1,D10---UDI0076,GACGTCTTAT-GGTGAACCGT,1,1,0,295,36.72
1,E12---UDI0093,TACTCATAAT-GCCACAGGGT,0,0,0,0,0.00
1,F10---UDI0078,CATAGAGTAT-TGGTGGCAGT,2,2,0,551,35.58
1,D09---UDI0068,CCTTCACCAT-GGAGCGTCGT,3,2,1,660,31.66
1,A05---UDI0033,TACCGAGGAT-AGTTCAGGGT,2493,2374,119,689871,35.54
1,A07---UDI0049,ATATCTCGAT-ACTAAGATGT,810,779,31,225399,35.65
1,H08---UDI0064,CCATTCGAAT-CGGACAACGT,1,0,1,175,28.38
1,G02---UDI0015,GGCTTAAGAT-GGTCACGAGT,147,142,5,40652,35.50
1,F12---UDI0094,CGTCTGCGAT-ATTGTGAAGT,0,0,0,0,0.00
1,H12---UDI0096,CTAGCGCTAT-GTCTACACGT,0,0,0,0,0.00
1,G04---UDI0031,GGCATTCTAT-CAAGCTAGGT,547,521,26,149841,35.37
1,H04---UDI0032,AATGCCTCAT-TGGATCGAGT,1967,1928,39,541852,35.46
1,G12---UDI0095,TCGATATCAT-ACTCGTGTGT,0,0,0,0,0.00
1,E02---UDI0013,CCAAGTCTAT-TCATCCTTGT,53,51,2,14296,35.13
1,F02---UDI0014,TTGGACTCAT-CTGCTTCCGT,2,1,1,527,34.94
1,D02---UDI0012,CTCTCGTCAT-AGGTTATAGT,1,1,0,273,35.57
1,B02---UDI0010,GACCTGAAAT-CTCACCAAGT,0,0,0,0,0.00
1,E11---UDI0085,AGGTTATAAT-CGGAACTGGT,1,1,0,245,32.88
1,D11---UDI0084,TCATCCTTAT-AGCTCGCTGT,0,0,0,0,0.00
1,G11---UDI0087,CTCACCAAAT-TTGCCTAGGT,8,7,1,2166,35.24
1,H05---UDI0040,CGGACAACAT-AATCCGGAGT,0,0,0,0,0.00
1,C08---UDI0059,GATCTATCAT-AGCCTCATGT,619,592,27,170894,35.49
1,C11---UDI0083,CTGCTTCCAT-GATCTATCGT,30,28,2,8254,35.49
1,F11---UDI0086,GAACCGCGAT-TAAGGTCAGT,0,0,0,0,0.00
1,C04---UDI0027,CTTGGTATAT-GGACTTGGGT,41,40,1,11218,35.31
1,B04---UDI0026,GTCGGAGCAT-TTATAACCGT,43,41,2,11613,35.08
1,F09---UDI0070,ATTGTGAAAT-GCAATGCAGT,0,0,0,0,0.00
1,G09---UDI0071,ACTCGTGTAT-GTTCCAATGT,1,1,0,294,36.68
1,H09---UDI0072,GTCTACACAT-ACCTTGGCGT,3,3,0,859,36.10
1,A04---UDI0025,ACTAAGATAT-CCGCGGTTGT,44,39,5,12406,35.90
1,B08---UDI0058,CATAATACAT-CGTTAGAAGT,712,693,19,197012,35.54
1,H11---UDI0088,TCTGTTGGAT-CCATTCGAGT,1,1,0,294,36.68
1,H03---UDI0024,ATGAGGCCAT-CAATTAACGT,24,24,0,6651,35.54
1,A08---UDI0057,TGCGGCGTAT-TACCGAGGGT,789,771,18,217872,35.52
1,A01---D701-D501--ATTACTCG-TATAGCCT-,ATTACTCGAT-AGGCTATAGT,0,0,0,0,0.00
1,B01---D701-D502--ATTACTCG-ATAGAGGC-,ATTACTCGAT-GCCTCTATGT,0,0,0,0,0.00
1,C01---D701-D503--ATTACTCG-CCTATCCT-,ATTACTCGAT-AGGATAGGGT,0,0,0,0,0.00
1,D01---D701-D504--ATTACTCG-GGCTCTGA-,ATTACTCGAT-TCAGAGCCGT,0,0,0,0,0.00
1,E01---D701-D505--ATTACTCG-AGGCGAAG-,ATTACTCGAT-CTTCGCCTGT,0,0,0,0,0.00
1,F01---D701-D506--ATTACTCG-TAATCTTA-,ATTACTCGAT-TAAGATTAGT,0,0,0,0,0.00
1,G01---D701-D507--ATTACTCG-CAGGACGT-,ATTACTCGAT-ACGTCCTGGT,0,0,0,0,0.00
1,H01---D701-D508--ATTACTCG-GTACTGAC-,ATTACTCGAT-GTCAGTACGT,0,0,0,0,0.00
1,A02---D702-D501--TCCGGAGA-TATAGCCT-,TCCGGAGAAT-AGGCTATAGT,0,0,0,0,0.00
1,B02---D702-D502--TCCGGAGA-ATAGAGGC-,TCCGGAGAAT-GCCTCTATGT,0,0,0,0,0.00
1,C02---D702-D503--TCCGGAGA-CCTATCCT-,TCCGGAGAAT-AGGATAGGGT,0,0,0,0,0.00
1,D02---D702-D504--TCCGGAGA-GGCTCTGA-,TCCGGAGAAT-TCAGAGCCGT,0,0,0,0,0.00
1,E02---D702-D505--TCCGGAGA-AGGCGAAG-,TCCGGAGAAT-CTTCGCCTGT,0,0,0,0,0.00
1,F02---D702-D506--TCCGGAGA-TAATCTTA-,TCCGGAGAAT-TAAGATTAGT,0,0,0,0,0.00
1,G02---D702-D507--TCCGGAGA-CAGGACGT-,TCCGGAGAAT-ACGTCCTGGT,0,0,0,0,0.00
1,H02---D702-D508--TCCGGAGA-GTACTGAC-,TCCGGAGAAT-GTCAGTACGT,0,0,0,0,0.00
1,A03---D703-D501--CGCTCATT-TATAGCCT-,CGCTCATTAT-AGGCTATAGT,0,0,0,0,0.00
1,B03---D703-D502--CGCTCATT-ATAGAGGC-,CGCTCATTAT-GCCTCTATGT,0,0,0,0,0.00
1,C03---D703-D503--CGCTCATT-CCTATCCT-,CGCTCATTAT-AGGATAGGGT,0,0,0,0,0.00
1,D03---D703-D504--CGCTCATT-GGCTCTGA-,CGCTCATTAT-TCAGAGCCGT,0,0,0,0,0.00
1,E03---D703-D505--CGCTCATT-AGGCGAAG-,CGCTCATTAT-CTTCGCCTGT,0,0,0,0,0.00
1,F03---D703-D506--CGCTCATT-TAATCTTA-,CGCTCATTAT-TAAGATTAGT,0,0,0,0,0.00
1,G03---D703-D507--CGCTCATT-CAGGACGT-,CGCTCATTAT-ACGTCCTGGT,0,0,0,0,0.00
1,H03---D703-D508--CGCTCATT-GTACTGAC-,CGCTCATTAT-GTCAGTACGT,0,0,0,0,0.00
1,A04---D704-D501--GAGATTCC-TATAGCCT-,GAGATTCCAT-AGGCTATAGT,0,0,0,0,0.00
1,B04---D704-D502--GAGATTCC-ATAGAGGC-,GAGATTCCAT-GCCTCTATGT,0,0,0,0,0.00
1,C04---D704-D503--GAGATTCC-CCTATCCT-,GAGATTCCAT-AGGATAGGGT,0,0,0,0,0.00
1,D04---D704-D504--GAGATTCC-GGCTCTGA-,GAGATTCCAT-TCAGAGCCGT,0,0,0,0,0.00
1,E04---D704-D505--GAGATTCC-AGGCGAAG-,GAGATTCCAT-CTTCGCCTGT,0,0,0,0,0.00
1,F04---D704-D506--GAGATTCC-TAATCTTA-,GAGATTCCAT-TAAGATTAGT,0,0,0,0,0.00
1,G04---D704-D507--GAGATTCC-CAGGACGT-,GAGATTCCAT-ACGTCCTGGT,0,0,0,0,0.00
1,H04---D704-D508--GAGATTCC-GTACTGAC-,GAGATTCCAT-GTCAGTACGT,0,0,0,0,0.00
1,A05---D705-D501--ATTCAGAA-TATAGCCT-,ATTCAGAAAT-AGGCTATAGT,0,0,0,0,0.00
1,B05---D705-D502--ATTCAGAA-ATAGAGGC-,ATTCAGAAAT-GCCTCTATGT,0,0,0,0,0.00
1,C05---D705-D503--ATTCAGAA-CCTATCCT-,ATTCAGAAAT-AGGATAGGGT,0,0,0,0,0.00
1,D05---D705-D504--ATTCAGAA-GGCTCTGA-,ATTCAGAAAT-TCAGAGCCGT,0,0,0,0,0.00
1,E05---D705-D505--ATTCAGAA-AGGCGAAG-,ATTCAGAAAT-CTTCGCCTGT,0,0,0,0,0.00
1,F05---D705-D506--ATTCAGAA-TAATCTTA-,ATTCAGAAAT-TAAGATTAGT,0,0,0,0,0.00
1,G05---D705-D507--ATTCAGAA-CAGGACGT-,ATTCAGAAAT-ACGTCCTGGT,0,0,0,0,0.00
1,H05---D705-D508--ATTCAGAA-GTACTGAC-,ATTCAGAAAT-GTCAGTACGT,0,0,0,0,0.00
1,A06---D706-D501--GAATTCGT-TATAGCCT-,GAATTCGTAT-AGGCTATAGT,0,0,0,0,0.00
1,B06---D706-D502--GAATTCGT-ATAGAGGC-,GAATTCGTAT-GCCTCTATGT,0,0,0,0,0.00
1,C06---D706-D503--GAATTCGT-CCTATCCT-,GAATTCGTAT-AGGATAGGGT,0,0,0,0,0.00
1,D06---D706-D504--GAATTCGT-GGCTCTGA-,GAATTCGTAT-TCAGAGCCGT,0,0,0,0,0.00
1,E06---D706-D505--GAATTCGT-AGGCGAAG-,GAATTCGTAT-CTTCGCCTGT,0,0,0,0,0.00
1,F06---D706-D506--GAATTCGT-TAATCTTA-,GAATTCGTAT-TAAGATTAGT,0,0,0,0,0.00
1,G06---D706-D507--GAATTCGT-CAGGACGT-,GAATTCGTAT-ACGTCCTGGT,0,0,0,0,0.00
1,H06---D706-D508--GAATTCGT-GTACTGAC-,GAATTCGTAT-GTCAGTACGT,0,0,0,0,0.00
1,A07---D707-D501--CTGAAGCT-TATAGCCT-,CTGAAGCTAT-AGGCTATAGT,0,0,0,0,0.00
1,B07---D707-D502--CTGAAGCT-ATAGAGGC-,CTGAAGCTAT-GCCTCTATGT,0,0,0,0,0.00
1,C07---D707-D503--CTGAAGCT-CCTATCCT-,CTGAAGCTAT-AGGATAGGGT,0,0,0,0,0.00
1,D07---D707-D504--CTGAAGCT-GGCTCTGA-,CTGAAGCTAT-TCAGAGCCGT,0,0,0,0,0.00
1,E07---D707-D505--CTGAAGCT-AGGCGAAG-,CTGAAGCTAT-CTTCGCCTGT,0,0,0,0,0.00
1,F07---D707-D506--CTGAAGCT-TAATCTTA-,CTGAAGCTAT-TAAGATTAGT,0,0,0,0,0.00
1,G07---D707-D507--CTGAAGCT-CAGGACGT-,CTGAAGCTAT-ACGTCCTGGT,0,0,0,0,0.00
1,H07---D707-D508--CTGAAGCT-GTACTGAC-,CTGAAGCTAT-GTCAGTACGT,0,0,0,0,0.00
1,A08---D708-D501--TAATGCGC-TATAGCCT-,TAATGCGCAT-AGGCTATAGT,0,0,0,0,0.00
1,B08---D708-D502--TAATGCGC-ATAGAGGC-,TAATGCGCAT-GCCTCTATGT,0,0,0,0,0.00
1,C08---D708-D503--TAATGCGC-CCTATCCT-,TAATGCGCAT-AGGATAGGGT,0,0,0,0,0.00
1,D08---D708-D504--TAATGCGC-GGCTCTGA-,TAATGCGCAT-TCAGAGCCGT,0,0,0,0,0.00
1,E08---D708-D505--TAATGCGC-AGGCGAAG-,TAATGCGCAT-CTTCGCCTGT,0,0,0,0,0.00
1,F08---D708-D506--TAATGCGC-TAATCTTA-,TAATGCGCAT-TAAGATTAGT,0,0,0,0,0.00
1,G08---D708-D507--TAATGCGC-CAGGACGT-,TAATGCGCAT-ACGTCCTGGT,0,0,0,0,0.00
1,H08---D708-D508--TAATGCGC-GTACTGAC-,TAATGCGCAT-GTCAGTACGT,0,0,0,0,0.00
1,A09---D709-D501--CGGCTATG-TATAGCCT-,CGGCTATGAT-AGGCTATAGT,0,0,0,0,0.00
1,B09---D709-D502--CGGCTATG-ATAGAGGC-,CGGCTATGAT-GCCTCTATGT,0,0,0,0,0.00
1,C09---D709-D503--CGGCTATG-CCTATCCT-,CGGCTATGAT-AGGATAGGGT,0,0,0,0,0.00
1,D09---D709-D504--CGGCTATG-GGCTCTGA-,CGGCTATGAT-TCAGAGCCGT,0,0,0,0,0.00
1,E09---D709-D505--CGGCTATG-AGGCGAAG-,CGGCTATGAT-CTTCGCCTGT,0,0,0,0,0.00
1,F09---D709-D506--CGGCTATG-TAATCTTA-,CGGCTATGAT-TAAGATTAGT,0,0,0,0,0.00
1,G09---D709-D507--CGGCTATG-CAGGACGT-,CGGCTATGAT-ACGTCCTGGT,0,0,0,0,0.00
1,H09---D709-D508--CGGCTATG-GTACTGAC-,CGGCTATGAT-GTCAGTACGT,0,0,0,0,0.00
1,A10---D710-D501--TCCGCGAA-TATAGCCT-,TCCGCGAAAT-AGGCTATAGT,0,0,0,0,0.00
1,B10---D710-D502--TCCGCGAA-ATAGAGGC-,TCCGCGAAAT-GCCTCTATGT,0,0,0,0,0.00
1,C10---D710-D503--TCCGCGAA-CCTATCCT-,TCCGCGAAAT-AGGATAGGGT,0,0,0,0,0.00
1,D10---D710-D504--TCCGCGAA-GGCTCTGA-,TCCGCGAAAT-TCAGAGCCGT,0,0,0,0,0.00
1,E10---D710-D505--TCCGCGAA-AGGCGAAG-,TCCGCGAAAT-CTTCGCCTGT,0,0,0,0,0.00
1,F10---D710-D506--TCCGCGAA-TAATCTTA-,TCCGCGAAAT-TAAGATTAGT,0,0,0,0,0.00
1,G10---D710-D507--TCCGCGAA-CAGGACGT-,TCCGCGAAAT-ACGTCCTGGT,0,0,0,0,0.00
1,H10---D710-D508--TCCGCGAA-GTACTGAC-,TCCGCGAAAT-GTCAGTACGT,0,0,0,0,0.00
1,A11---D711-D501--TCTCGCGC-TATAGCCT-,TCTCGCGCAT-AGGCTATAGT,0,0,0,0,0.00
1,B11---D711-D502--TCTCGCGC-ATAGAGGC-,TCTCGCGCAT-GCCTCTATGT,0,0,0,0,0.00
1,C11---D711-D503--TCTCGCGC-CCTATCCT-,TCTCGCGCAT-AGGATAGGGT,0,0,0,0,0.00
1,D11---D711-D504--TCTCGCGC-GGCTCTGA-,TCTCGCGCAT-TCAGAGCCGT,0,0,0,0,0.00
1,E11---D711-D505--TCTCGCGC-AGGCGAAG-,TCTCGCGCAT-CTTCGCCTGT,0,0,0,0,0.00
1,F11---D711-D506--TCTCGCGC-TAATCTTA-,TCTCGCGCAT-TAAGATTAGT,0,0,0,0,0.00
1,G11---D711-D507--TCTCGCGC-CAGGACGT-,TCTCGCGCAT-ACGTCCTGGT,0,0,0,0,0.00
1,H11---D711-D508--TCTCGCGC-GTACTGAC-,TCTCGCGCAT-GTCAGTACGT,0,0,0,0,0.00
1,A12---D712-D501--AGCGATAG-TATAGCCT-,AGCGATAGAT-AGGCTATAGT,0,0,0,0,0.00
1,B12---D712-D502--AGCGATAG-ATAGAGGC-,AGCGATAGAT-GCCTCTATGT,0,0,0,0,0.00
1,C12---D712-D503--AGCGATAG-CCTATCCT-,AGCGATAGAT-AGGATAGGGT,0,0,0,0,0.00
1,D12---D712-D504--AGCGATAG-GGCTCTGA-,AGCGATAGAT-TCAGAGCCGT,0,0,0,0,0.00
1,E12---D712-D505--AGCGATAG-AGGCGAAG-,AGCGATAGAT-CTTCGCCTGT,0,0,0,0,0.00
1,F12---D712-D506--AGCGATAG-TAATCTTA-,AGCGATAGAT-TAAGATTAGT,0,0,0,0,0.00
1,G12---D712-D507--AGCGATAG-CAGGACGT-,AGCGATAGAT-ACGTCCTGGT,0,0,0,0,0.00
1,H12---D712-D508--AGCGATAG-GTACTGAC-,AGCGATAGAT-GTCAGTACGT,0,0,0,0,0.00
1,Duplex-primer--6-F1---TTCCAAGG-CCTTGTAG-,TTCCAAGGAT-CTACAAGGGT,0,0,0,0,0.00
1,Duplex-primer--10-B2---ATCGATCG-TGCTTCCA-,ATCGATCGAT-TGGAAGCAGT,0,0,0,0,0.00
1,Duplex-primer--14-F2---TGGACTCT-CCGTAAGA-,TGGACTCTAT-TCTTACGGGT,0,0,0,0,0.00
1,Duplex-primer--4-D1---GAGACGAT-TAACCGGT-,GAGACGATAT-ACCGGTTAGT,0,0,0,0,0.00
1,Duplex-primer--13-E2---TACGCTAC-ATCACACG-,TACGCTACAT-CGTGTGATGT,0,0,0,0,0.00
1,Duplex-primer--7-G1---CGCATGAT-TCAGGCTT-,CGCATGATAT-AAGCCTGAGT,0,0,0,0,0.00
1,Duplex-primer--9-A2---CGGCTAAT-AGAACGAG-,CGGCTAATAT-CTCGTTCTGT,0,0,0,0,0.00
1,Duplex-primer--12-D2---GCTATCCT-CACCTGTT-,GCTATCCTAT-AACAGGTGGT,0,0,0,0,0.00
1,Duplex-primer--1-A1---CTGATCGT-ATATGCGC-,CTGATCGTAT-GCGCATATGT,0,0,0,0,0.00
1,Duplex-primer--15-G2---AGAGTAGC-TACGCCTT-,AGAGTAGCAT-AAGGCGTAGT,0,0,0,0,0.00
1,Duplex-primer--11-C2---GCAAGATC-CTTCGACT-,GCAAGATCAT-AGTCGAAGGT,0,0,0,0,0.00
1,Duplex-primer--2-B1---ACTCTCGA-TGGTACAG-,ACTCTCGAAT-CTGTACCAGT,0,0,0,0,0.00
1,Duplex-primer--3-C1---TGAGCTAG-AACCGTTC-,TGAGCTAGAT-GAACGGTTGT,0,0,0,0,0.00
1,Duplex-primer--8-H1---ACGGAACA-GTTCTCGT-,ACGGAACAAT-ACGAGAACGT,2,0,2,248,24.69
1,Duplex-primer--5-E1---CTTGTCGA-GAACATCG-,CTTGTCGAAT-CGATGTTCGT,0,0,0,0,0.00
1,Duplex-primer--16-H2---ATCCAGAG-CGACGTTA-,ATCCAGAGAT-TAACGTCGGT,0,0,0,0,0.00
1,Undetermined,Undetermined,164958728,164958728,0,42126543976,34.01
2,ACC7880A64,TCAAGTTCCT-CAAGTTCTAG,5025306,4881919,143387,1413197192,35.81
2,ACC7880A83,TCGTGGCTAG-GCCAGCAGTA,5354944,5208648,146296,1486512478,35.56
2,ACC7880A65,AGACCTAGCT-CACAAGTATC,5069616,4957395,112221,1429559652,35.87
2,ACC7880A71,CTGCGTACTC-CTGATGGCAA,5584169,5450632,133537,1563209725,35.72
2,ACC7880A78,CGCAGAACTT-TATCGACGTC,5922387,5779081,143306,1667844727,35.84
2,ACC7880A16,TCGCTTAAGC-CTAGGCGTGT,5255811,5182066,73745,1469377718,35.70
2,ACC7880A70,TTCACACAGT-CTTCAGTGTT,4043396,3973480,69916,1135618898,35.79
2,ACC7880A36,GCTGCCGATA-TATCCTACGT,4509147,4443214,65933,1272095064,35.87
2,ACC7880A72,TGGATATGGC-TGGCGCGTAT,8133174,7990223,142951,2255630275,35.55
2,ACC7880A84,AGGACTGAAC-TGAAGCGACG,6653614,6538686,114928,1865077027,35.75
2,ACC7880A27,TTAGGAGGAA-GAACTTGCGT,5155728,4990926,164802,1423261765,35.47
2,ACC7880A51,GAGCATCCAT-TCACGTCCAC,2049748,2018789,30959,574506730,35.74
2,ACC7880A76,AATGTGGCGT-TGTCAGGTAG,4746118,4658907,87211,1335800608,35.83
2,ACC7880A10,CTAGTCAGAA-TTGAATGCTG,5274474,5172139,102335,1468391801,35.62
2,ACC7880A85,GCTGAGAGCT-GTGATAGGTG,5274316,5084449,189867,1472213026,35.68
2,ACC7880A77,GCTACTGTCG-CTTGCTCCAT,2839364,2776136,63228,785589910,35.49
2,ACC7880A17,AAGACAGCTT-TCGCTGACCT,7354842,7226401,128441,2045896810,35.59
2,ACC7880A80,GTTCCACCGA-CCTGCTGTTA,4794100,4697628,96472,1297047769,34.95
2,ACC7880A59,CGGAACGAAG-ACCATCGCCT,6469088,6301560,167528,1814929163,35.76
2,ACC7880A49,GACGAACGTA-TCGTCCTTCA,6208778,6078971,129807,1685151354,35.12
2,ACC7880A24,GACAATAGAG-TAGTGTACAC,5590201,3517793,2072408,1512749178,35.06
2,ACC7880A63,TCAGCACCGT-ACTGAATAGG,5278797,5178169,100628,1461342793,35.51
2,ACC7880A25,AGACGGCATC-AAGGTAACCT,4982744,4871165,111579,1369501378,35.39
2,ACC7880A87,AATGGTACTG-ACAGCAGTTA,5731687,5598610,133077,1575094169,35.37
2,ACC7880A23,TGCCACTGTA-CAGCAGGTCA,4763791,4653658,110133,1308957426,35.37
2,ACC7880A20,AGCTATCTTC-GTGTCGCTAG,5314983,5183492,131491,1487793090,35.72
2,ACC7880A39,ATACCTGTGA-GCATTGTGCT,3035794,2975444,60350,830262219,35.26
2,ACC7880A33,TTGGCCAGTT-ATGCTACCTG,6175237,6017043,158194,1730175512,35.74
2,ACC7880A9,CGATGAGACT-TTAGTCGTGC,4459591,4370086,89505,1242005822,35.63
2,ACC7880A41,AGAGATGGTA-GCTTACGGAA,2033749,801010,1232739,563267539,35.52
2,ACC7880A67,GCCTAGGACT-GAGAACGGCT,5382283,5273474,108809,1513975028,35.82
2,ACC7880A28,ACAGAAGGTT-TGGAGATATC,6075832,5980349,95483,1709882754,35.83
2,ACC7880A57,ACGCGGACTT-TATTGCCTCG,7719683,7560996,158687,2178381800,35.88
2,ACC7880A32,AACGACGCAT-AACTACAACG,8522033,8391966,130067,2384840069,35.70
2,ACC7880A40,TCAGATTCAC-TGGAGTGCGA,2259431,2192214,67217,629324896,35.63
2,ACC7880A48,CCGACTCCTT-ACTGTCCTTG,1729543,1650821,78722,482929318,35.68
2,ACC7880A44,TCACCGTCAC-CAACTCCTTA,8287229,8093146,194083,2328561811,35.79
2,ACC7880A56,CTATAGCGAG-AGTCGACTAG,5477434,5316651,160783,1533694713,35.74
2,ACC7880A89,TCACCAGGAC-TCCTTGTCTC,7315597,7208235,107362,2033336505,35.57
2,ACC7880A11,CGATAGCAGG-TCGTAGCATT,4246457,4179138,67319,1162416405,35.27
2,ACC7880A68,TTCCACCTGG-ATGAGCTTCT,6365794,6241773,124021,1711825237,34.93
2,ACC7880A3,TGTGAGCGAA-GATCGGAGTT,4229001,4163149,65852,1155148898,35.25
2,ACC7880A74,CTCTCATGCG-ACGTCGGTTG,5520499,5394970,125529,1500330892,35.14
2,ACC7880A18,TATCACTCTC-ACCTTGTTCT,5870592,5457983,412609,1606654945,35.31
2,ACC7880A46,GTGTTATCTC-ACACCAGACT,6793895,6420418,373477,1883695472,35.54
2,ACC7880A38,CTATACACCA-CCAACTACGG,3515188,3434238,80950,937531320,34.69
2,ACC7880A30,TTCAGGTCGT-TTGGTTGGTT,7222742,7076172,146570,2003129048,35.55
2,ACC7880A22,AGAGGAATCG-CCAGACTATC,4640010,4526382,113628,1274563537,35.36
2,ACC7880A26,ACTGGTGTCG-CAAGTCCTGT,6484940,6341462,143478,1805332221,35.61
2,ACC7880A29,GAGAGCTAAC-CAATACTTGC,6140361,6035776,104585,1714108120,35.67
2,ACC7880A50,CCACTGTGAC-TGGACAGATG,6974813,6837319,137494,1939478863,35.59
2,ACC7880A8,AATCTCAGGC-TCTCTAACTC,1783767,1748620,35147,494347269,35.52
2,ACC7880A58,AGAATCCTTC-TGCCAGGTGT,3262187,3090581,171606,915136169,35.78
2,ACC7880A21,AGGTGGCTAC-CCACGTAACG,6079350,5982551,96799,1702721176,35.73
2,ACC7880A75,CAACCGATTA-TGCTGAGTTA,5310077,5144062,166015,1475124850,35.58
2,ACC7880A69,TTATCTGTGC-CACTCAGTAT,4068590,3998189,70401,1127800945,35.53
2,ACC7880A90,TAATCTACGG-CTGGCACTTA,5852647,5719974,132673,1619956945,35.50
2,ACC7880A82,GAGCTCCACA-CAGAACAGAA,2481635,2411084,70551,660484029,34.63
2,ACC7880A52,GTTATTAGGC-CTCGATGAAC,3457945,3355063,102882,964733710,35.67
2,ACC7880A47,AACACAGCCG-AGACCTTGGT,4270291,4180618,89673,1170435345,35.29
2,ACC7880A54,CGCTTAAGTA-ATTACTGCAC,6062249,5949615,112634,1668892658,35.41
2,ACC7880A62,CACGGTTGGT-CTAGCTGAAT,5175061,5067630,107431,1428890309,35.46
2,ACC7880A81,GACGTTCTCT-AGTAGAGCTA,5817675,5640946,176729,1628550687,35.72
2,ACC7880A5,AACAACCTCA-TTGGACTAAG,1062346,1034265,28081,289786191,35.21
2,ACC7880A31,CTTGTCTTGC-AACCAATGTG,4553344,4464520,88824,1261006147,35.52
2,ACC7880A4,GATGAAGGAT-GAATAAGGCT,1190472,1172455,18017,332545878,35.67
2,ACC7880A66,GCCTTACTTA-GCACCTTAAC,4519804,4428220,91584,1265565950,35.73
2,ACC7880A34,ATTGCGGCTG-TGTCCTACAA,5732218,5532834,199384,1595693611,35.61
2,ACC7880A12,TATGGTGATG-TTCAAGTAGC,6730594,6577604,152990,1882649225,35.71
2,ACC7880A14,CCGGTTCATG-AGACGTCTTG,1346688,1298745,47943,366772228,35.22
2,ACC7880A60,TATCGTTGTG-TGTGTCCGCA,6115071,5927327,187744,1711915626,35.73
2,ACC7880A19,GCTGCTAACA-AGCTCTTGTG,4178897,4071999,106898,1165055797,35.65
2,ACC7880A7,ACCGACGTGA-AACGGTCATG,5053255,4954905,98350,1339110083,34.62
2,ACC7880A88,CAGCCTTGAG-TGAGTAGCAT,5231310,3709921,1521389,1437825923,35.36
2,ACC7880A37,GAATGTCCAA-GAATACCGTA,6001140,5816473,184667,1671778760,35.62
2,ACC7880A13,GTTGGACGGT-AGGACACTGT,3852379,3782397,69982,1067274274,35.53
2,ACC7880A45,TGTGAAGCTA-ACGCGATTCA,5392525,5262272,130253,1476904529,35.30
2,ACC7880A53,TTATCGCTGA-TTAGGATTGG,6936161,6799523,136638,1857057686,34.83
2,ACC7880A1,ATTCCACACT-TGGTCTTGTT,3551326,3473418,77908,974667847,35.36
2,ACC7880A55,TTACGGAACA-TGACTCTGTC,2423595,2380515,43080,672682141,35.55
2,ACC7880A2,TACTAGAGGA-GAACCGGTCT,3795441,3724097,71344,1003835083,34.51
2,ACC7880A61,AACACAACGA-ACGCAGCCAA,6494523,6309105,185418,1752031786,34.89
2,ACC7880A79,CCAAGACACT-ACCGACATGG,2083272,2014607,68665,573747231,35.41
2,ACC7880A86,GAGCTTATGA-ACCAGTCATT,6284020,6182216,101804,1713214017,35.13
2,ACC7880A42,ATGGAGACGG-CTGAGAGTTC,6013497,5906675,106822,1645307561,35.28
2,ACC7880A43,GTGTACGTCG-TCCTAGCAGG,4910386,4820645,89741,1378034333,35.77
2,ACC7880A35,AGAGACTTAC-TAAGAGTTGG,4148954,4069591,79363,1166519865,35.81
2,ACC7880A6,AGATCTTCCA-GTGTTGATCT,2411230,2360997,50233,630512904,34.36
2,ACC7880A15,TTGGCCATAC-GCCTAGTGCA,5879002,5755080,123922,1645902146,35.73
2,ACC7880A73,TATAACTCCG-TATGTGTCCT,5653519,5543523,109996,1572632861,35.59
2,ACC7804A22,GGTCACGAAT-CATAATACGT,37490842,36865934,624908,10331703019,35.46
2,ACC7804A13,AGTACTCCAT-AACAGGTTGT,58086432,56441701,1644731,16020543521,35.47
2,ACC7809A1,TATCGCACAT-ACACTAAGGT,23448791,22735581,713210,6368131944,35.18
2,ACC7795A1,CAACAATGAT-CCGTGAAGGT,299291817,293476394,5815423,82402869772,35.44
2,ACC7804A15,TGCGAGACAT-CAACAATGGT,28230288,27646891,583397,7785657635,35.47
2,ACC7809A2,CGCTATGTAT-GTGTCGGAGT,31427552,30198281,1229271,8461767720,35.01
2,ACC7795A2,TGGTGGCAAT-TTACAGGAGT,120530174,117962084,2568090,33094846897,35.40
2,ACC7804A18,GTATGTTCAT-TTCCTGTTGT,16498570,15811155,687415,4479517021,35.19
2,ACC7807A1,ACGCACCTAT-CCTTCACCGT,16774033,16280349,493684,4524077249,35.07
2,ACC7866A1,CCGCGGTTAT-CTAGCGCTGT,139613265,134711623,4901642,38570924616,35.51
2,ACC7866A9,AGTTCAGGAT-TCTGTTGGGT,98691988,95661275,3030713,27101271137,35.41
2,ACC7872A3,TAATACAGAT-GTGAATATGT,104645831,101479150,3166681,28824218216,35.45
2,ACC7866A2,TTATAACCAT-TCGATATCGT,92753234,90796115,1957119,25551802640,35.45
2,ACC7872A4,CGGCGTGAAT-ACAGGCGCGT,96034522,93141714,2892808,26466646592,35.47
2,ACC7866A3,GGACTTGGAT-CGTCTGCGGT,76319900,74806278,1513622,21030683859,35.46
2,ACC7804A17,TCTCTACTAT-GAACCGCGGT,82289300,69653615,12635685,22561208410,35.37
2,ACC7872A5,ATGTAAGTAT-CATAGAGTGT,105091355,102400448,2690907,28856092339,35.40
2,ACC7866A4,AAGTCCAAAT-TACTCATAGT,101004615,98628080,2376535,27840772006,35.46
2,ACC7872A6,GCACGGACAT-TGCGAGACGT,92529639,90433478,2096161,25520192655,35.48
2,ACC7866A5,ATCCACTGAT-ACGCACCTGT,95425577,92566456,2859121,26233935965,35.42
2,ACC7872A7,GGTACCTTAT-GACGTCTTGT,127311497,123389725,3921772,35161654832,35.50
2,ACC7866A6,GCTTGTCAAT-GTATGTTCGT,84283127,81279682,3003445,23230386865,35.46
2,ACC7872A8,AACGTTCCAT-AGTACTCCGT,86641094,84165032,2476062,23923911591,35.49
2,ACC7866A7,CAAGCTAGAT-CGCTATGTGT,95533091,92986193,2546898,26343765291,35.47
2,ACC7872A9,GCAGAATTAT-TGGCCGGTGT,110534367,108205323,2329044,30541127110,35.51
2,ACC7866A8,TGGATCGAAT-TATCGCACGT,83452123,81371245,2080878,23040305140,35.49
2,ACC7872A2,AATCCGGAAT-AACTGTAGGT,88894478,84942843,3951635,24087269172,35.17
2,C07---UDI0051,AACAGGTTAT-CTTGGTATGT,953,911,42,262125,35.44
2,H06---UDI0048,ACCTTGGCAT-ATGAGGCCGT,845,764,81,232291,35.45
2,B07---UDI0050,GCGCTCTAAT-GTCGGAGCGT,807,779,28,222571,35.46
2,G06---UDI0047,GTTCCAATAT-GCAGAATTGT,936,915,21,259333,35.55
2,C06---UDI0043,AAGATACTAT-ATGTAAGTGT,804,775,29,222927,35.56
2,F06---UDI0046,GCAATGCAAT-AACGTTCCGT,705,683,22,193595,35.39
2,A06---UDI0041,ATATGGATAT-TAATACAGGT,1016,984,32,281334,35.55
2,G05---UDI0039,TAAGTGGTAT-GGCTTAAGGT,0,0,0,0,0.00
2,F08---UDI0062,TAAGGTCAAT-CTACGACAGT,808,793,15,222640,35.48
2,B06---UDI0042,GCGCAAGCAT-CGGCGTGAGT,705,687,18,192487,35.29
2,H07---UDI0056,GAATGAGAAT-AATGCCTCGT,846,826,20,234148,35.54
2,H10---UDI0080,GTGAATATAT-GAATGAGAGT,0,0,0,0,0.00
2,G07---UDI0055,AGGCAGAGAT-GGCATTCTGT,749,520,229,206017,35.43
2,G08---UDI0063,TTGCCTAGAT-TAAGTGGTGT,805,786,19,222886,35.56
2,B05---UDI0034,CGTTAGAAAT-GACCTGAAGT,939,911,28,257828,35.40
2,E04---UDI0029,CCGTGAAGAT-ATCCACTGGT,46,44,2,12590,35.40
2,D05---UDI0036,GATTCTGCAT-CTCTCGTCGT,3,3,0,695,31.95
2,C05---UDI0035,AGCCTCATAT-TCTCTACTGT,27,27,0,7388,35.29
2,D04---UDI0028,TCCAACGCAT-AAGTCCAAGT,31,29,2,8329,35.08
2,E08---UDI0061,CGGAACTGAT-TCGTAGTGGT,751,729,22,207074,35.47
2,D08---UDI0060,AGCTCGCTAT-GATTCTGCGT,902,841,61,246807,35.35
2,F05---UDI0038,CTACGACAAT-TTGGACTCGT,2,2,0,556,35.70
2,A10---UDI0073,CAATTAACAT-ATATCTCGGT,26,22,4,6925,34.86
2,E06---UDI0045,ATGGCATGAT-GGTACCTTGT,790,764,26,217041,35.42
2,A11---UDI0081,AACTGTAGAT-TGCGGCGTGT,34,34,0,9329,35.40
2,D06---UDI0044,GGAGCGTCAT-GCACGGACGT,764,758,6,211149,35.50
2,B10---UDI0074,TGGCCGGTAT-GCGCTCTAGT,1,1,0,296,36.72
2,E05---UDI0037,TCGTAGTGAT-CCAAGTCTGT,1,1,0,263,34.75
2,D07---UDI0052,GGTGAACCAT-TCCAACGCGT,0,0,0,0,0.00
2,A09---UDI0065,ACACTAAGAT-ATATGGATGT,1260,1200,60,344183,35.28
2,C09---UDI0067,TTCCTGTTAT-AAGATACTGT,2,2,0,580,36.43
2,E09---UDI0069,GCCACAGGAT-ATGGCATGGT,0,0,0,0,0.00
2,G10---UDI0079,ACAGGCGCAT-AGGCAGAGGT,1,1,0,253,34.08
2,F04---UDI0030,TTACAGGAAT-GCTTGTCAGT,40,34,6,10572,34.74
2,B09---UDI0066,GTGTCGGAAT-GCGCAAGCGT,1,1,0,294,36.59
2,D10---UDI0076,GACGTCTTAT-GGTGAACCGT,0,0,0,0,0.00
2,E12---UDI0093,TACTCATAAT-GCCACAGGGT,0,0,0,0,0.00
2,F10---UDI0078,CATAGAGTAT-TGGTGGCAGT,0,0,0,0,0.00
2,D09---UDI0068,CCTTCACCAT-GGAGCGTCGT,0,0,0,0,0.00
2,A05---UDI0033,TACCGAGGAT-AGTTCAGGGT,2856,2718,138,786834,35.47
2,A07---UDI0049,ATATCTCGAT-ACTAAGATGT,910,876,34,250719,35.45
2,H08---UDI0064,CCATTCGAAT-CGGACAACGT,2,2,0,521,34.38
2,G02---UDI0015,GGCTTAAGAT-GGTCACGAGT,157,150,7,42836,35.23
2,F12---UDI0094,CGTCTGCGAT-ATTGTGAAGT,0,0,0,0,0.00
2,H12---UDI0096,CTAGCGCTAT-GTCTACACGT,0,0,0,0,0.00
2,G04---UDI0031,GGCATTCTAT-CAAGCTAGGT,658,632,26,180094,35.37
2,H04---UDI0032,AATGCCTCAT-TGGATCGAGT,2237,2187,50,617191,35.48
2,G12---UDI0095,TCGATATCAT-ACTCGTGTGT,0,0,0,0,0.00
2,E02---UDI0013,CCAAGTCTAT-TCATCCTTGT,31,31,0,8409,35.20
2,F02---UDI0014,TTGGACTCAT-CTGCTTCCGT,0,0,0,0,0.00
2,D02---UDI0012,CTCTCGTCAT-AGGTTATAGT,0,0,0,0,0.00
2,B02---UDI0010,GACCTGAAAT-CTCACCAAGT,0,0,0,0,0.00
2,E11---UDI0085,AGGTTATAAT-CGGAACTGGT,0,0,0,0,0.00
2,D11---UDI0084,TCATCCTTAT-AGCTCGCTGT,0,0,0,0,0.00
2,G11---UDI0087,CTCACCAAAT-TTGCCTAGGT,6,6,0,1640,35.31
2,H05---UDI0040,CGGACAACAT-AATCCGGAGT,0,0,0,0,0.00
2,C08---UDI0059,GATCTATCAT-AGCCTCATGT,732,697,35,200319,35.33
2,C11---UDI0083,CTGCTTCCAT-GATCTATCGT,26,25,1,7278,35.71
2,F11---UDI0086,GAACCGCGAT-TAAGGTCAGT,1,1,0,288,36.35
2,C04---UDI0027,CTTGGTATAT-GGACTTGGGT,34,32,2,9503,35.78
2,B04---UDI0026,GTCGGAGCAT-TTATAACCGT,24,23,1,6574,35.31
2,F09---UDI0070,ATTGTGAAAT-GCAATGCAGT,0,0,0,0,0.00
2,G09---UDI0071,ACTCGTGTAT-GTTCCAATGT,3,3,0,845,35.94
2,H09---UDI0072,GTCTACACAT-ACCTTGGCGT,1,1,0,296,36.76
2,A04---UDI0025,ACTAAGATAT-CCGCGGTTGT,31,29,2,8480,35.41
2,B08---UDI0058,CATAATACAT-CGTTAGAAGT,776,761,15,214923,35.57
2,H11---UDI0088,TCTGTTGGAT-CCATTCGAGT,0,0,0,0,0.00
2,H03---UDI0024,ATGAGGCCAT-CAATTAACGT,16,16,0,4300,35.13
2,A08---UDI0057,TGCGGCGTAT-TACCGAGGGT,972,948,24,269231,35.55
2,A01---D701-D501--ATTACTCG-TATAGCCT-,ATTACTCGAT-AGGCTATAGT,0,0,0,0,0.00
2,B01---D701-D502--ATTACTCG-ATAGAGGC-,ATTACTCGAT-GCCTCTATGT,0,0,0,0,0.00
2,C01---D701-D503--ATTACTCG-CCTATCCT-,ATTACTCGAT-AGGATAGGGT,0,0,0,0,0.00
2,D01---D701-D504--ATTACTCG-GGCTCTGA-,ATTACTCGAT-TCAGAGCCGT,0,0,0,0,0.00
2,E01---D701-D505--ATTACTCG-AGGCGAAG-,ATTACTCGAT-CTTCGCCTGT,0,0,0,0,0.00
2,F01---D701-D506--ATTACTCG-TAATCTTA-,ATTACTCGAT-TAAGATTAGT,0,0,0,0,0.00
2,G01---D701-D507--ATTACTCG-CAGGACGT-,ATTACTCGAT-ACGTCCTGGT,0,0,0,0,0.00
2,H01---D701-D508--ATTACTCG-GTACTGAC-,ATTACTCGAT-GTCAGTACGT,0,0,0,0,0.00
2,A02---D702-D501--TCCGGAGA-TATAGCCT-,TCCGGAGAAT-AGGCTATAGT,0,0,0,0,0.00
2,B02---D702-D502--TCCGGAGA-ATAGAGGC-,TCCGGAGAAT-GCCTCTATGT,0,0,0,0,0.00
2,C02---D702-D503--TCCGGAGA-CCTATCCT-,TCCGGAGAAT-AGGATAGGGT,0,0,0,0,0.00
2,D02---D702-D504--TCCGGAGA-GGCTCTGA-,TCCGGAGAAT-TCAGAGCCGT,0,0,0,0,0.00
2,E02---D702-D505--TCCGGAGA-AGGCGAAG-,TCCGGAGAAT-CTTCGCCTGT,0,0,0,0,0.00
2,F02---D702-D506--TCCGGAGA-TAATCTTA-,TCCGGAGAAT-TAAGATTAGT,0,0,0,0,0.00
2,G02---D702-D507--TCCGGAGA-CAGGACGT-,TCCGGAGAAT-ACGTCCTGGT,0,0,0,0,0.00
2,H02---D702-D508--TCCGGAGA-GTACTGAC-,TCCGGAGAAT-GTCAGTACGT,0,0,0,0,0.00
2,A03---D703-D501--CGCTCATT-TATAGCCT-,CGCTCATTAT-AGGCTATAGT,0,0,0,0,0.00
2,B03---D703-D502--CGCTCATT-ATAGAGGC-,CGCTCATTAT-GCCTCTATGT,0,0,0,0,0.00
2,C03---D703-D503--CGCTCATT-CCTATCCT-,CGCTCATTAT-AGGATAGGGT,0,0,0,0,0.00
2,D03---D703-D504--CGCTCATT-GGCTCTGA-,CGCTCATTAT-TCAGAGCCGT,0,0,0,0,0.00
2,E03---D703-D505--CGCTCATT-AGGCGAAG-,CGCTCATTAT-CTTCGCCTGT,0,0,0,0,0.00
2,F03---D703-D506--CGCTCATT-TAATCTTA-,CGCTCATTAT-TAAGATTAGT,0,0,0,0,0.00
2,G03---D703-D507--CGCTCATT-CAGGACGT-,CGCTCATTAT-ACGTCCTGGT,0,0,0,0,0.00
2,H03---D703-D508--CGCTCATT-GTACTGAC-,CGCTCATTAT-GTCAGTACGT,0,0,0,0,0.00
2,A04---D704-D501--GAGATTCC-TATAGCCT-,GAGATTCCAT-AGGCTATAGT,0,0,0,0,0.00
2,B04---D704-D502--GAGATTCC-ATAGAGGC-,GAGATTCCAT-GCCTCTATGT,0,0,0,0,0.00
2,C04---D704-D503--GAGATTCC-CCTATCCT-,GAGATTCCAT-AGGATAGGGT,0,0,0,0,0.00
2,D04---D704-D504--GAGATTCC-GGCTCTGA-,GAGATTCCAT-TCAGAGCCGT,0,0,0,0,0.00
2,E04---D704-D505--GAGATTCC-AGGCGAAG-,GAGATTCCAT-CTTCGCCTGT,0,0,0,0,0.00
2,F04---D704-D506--GAGATTCC-TAATCTTA-,GAGATTCCAT-TAAGATTAGT,0,0,0,0,0.00
2,G04---D704-D507--GAGATTCC-CAGGACGT-,GAGATTCCAT-ACGTCCTGGT,0,0,0,0,0.00
2,H04---D704-D508--GAGATTCC-GTACTGAC-,GAGATTCCAT-GTCAGTACGT,0,0,0,0,0.00
2,A05---D705-D501--ATTCAGAA-TATAGCCT-,ATTCAGAAAT-AGGCTATAGT,0,0,0,0,0.00
2,B05---D705-D502--ATTCAGAA-ATAGAGGC-,ATTCAGAAAT-GCCTCTATGT,0,0,0,0,0.00
2,C05---D705-D503--ATTCAGAA-CCTATCCT-,ATTCAGAAAT-AGGATAGGGT,0,0,0,0,0.00
2,D05---D705-D504--ATTCAGAA-GGCTCTGA-,ATTCAGAAAT-TCAGAGCCGT,0,0,0,0,0.00
2,E05---D705-D505--ATTCAGAA-AGGCGAAG-,ATTCAGAAAT-CTTCGCCTGT,0,0,0,0,0.00
2,F05---D705-D506--ATTCAGAA-TAATCTTA-,ATTCAGAAAT-TAAGATTAGT,0,0,0,0,0.00
2,G05---D705-D507--ATTCAGAA-CAGGACGT-,ATTCAGAAAT-ACGTCCTGGT,0,0,0,0,0.00
2,H05---D705-D508--ATTCAGAA-GTACTGAC-,ATTCAGAAAT-GTCAGTACGT,0,0,0,0,0.00
2,A06---D706-D501--GAATTCGT-TATAGCCT-,GAATTCGTAT-AGGCTATAGT,0,0,0,0,0.00
2,B06---D706-D502--GAATTCGT-ATAGAGGC-,GAATTCGTAT-GCCTCTATGT,0,0,0,0,0.00
2,C06---D706-D503--GAATTCGT-CCTATCCT-,GAATTCGTAT-AGGATAGGGT,0,0,0,0,0.00
2,D06---D706-D504--GAATTCGT-GGCTCTGA-,GAATTCGTAT-TCAGAGCCGT,0,0,0,0,0.00
2,E06---D706-D505--GAATTCGT-AGGCGAAG-,GAATTCGTAT-CTTCGCCTGT,0,0,0,0,0.00
2,F06---D706-D506--GAATTCGT-TAATCTTA-,GAATTCGTAT-TAAGATTAGT,0,0,0,0,0.00
2,G06---D706-D507--GAATTCGT-CAGGACGT-,GAATTCGTAT-ACGTCCTGGT,0,0,0,0,0.00
2,H06---D706-D508--GAATTCGT-GTACTGAC-,GAATTCGTAT-GTCAGTACGT,0,0,0,0,0.00
2,A07---D707-D501--CTGAAGCT-TATAGCCT-,CTGAAGCTAT-AGGCTATAGT,0,0,0,0,0.00
2,B07---D707-D502--CTGAAGCT-ATAGAGGC-,CTGAAGCTAT-GCCTCTATGT,0,0,0,0,0.00
2,C07---D707-D503--CTGAAGCT-CCTATCCT-,CTGAAGCTAT-AGGATAGGGT,0,0,0,0,0.00
2,D07---D707-D504--CTGAAGCT-GGCTCTGA-,CTGAAGCTAT-TCAGAGCCGT,0,0,0,0,0.00
2,E07---D707-D505--CTGAAGCT-AGGCGAAG-,CTGAAGCTAT-CTTCGCCTGT,0,0,0,0,0.00
2,F07---D707-D506--CTGAAGCT-TAATCTTA-,CTGAAGCTAT-TAAGATTAGT,0,0,0,0,0.00
2,G07---D707-D507--CTGAAGCT-CAGGACGT-,CTGAAGCTAT-ACGTCCTGGT,0,0,0,0,0.00
2,H07---D707-D508--CTGAAGCT-GTACTGAC-,CTGAAGCTAT-GTCAGTACGT,0,0,0,0,0.00
2,A08---D708-D501--TAATGCGC-TATAGCCT-,TAATGCGCAT-AGGCTATAGT,0,0,0,0,0.00
2,B08---D708-D502--TAATGCGC-ATAGAGGC-,TAATGCGCAT-GCCTCTATGT,0,0,0,0,0.00
2,C08---D708-D503--TAATGCGC-CCTATCCT-,TAATGCGCAT-AGGATAGGGT,0,0,0,0,0.00
2,D08---D708-D504--TAATGCGC-GGCTCTGA-,TAATGCGCAT-TCAGAGCCGT,0,0,0,0,0.00
2,E08---D708-D505--TAATGCGC-AGGCGAAG-,TAATGCGCAT-CTTCGCCTGT,0,0,0,0,0.00
2,F08---D708-D506--TAATGCGC-TAATCTTA-,TAATGCGCAT-TAAGATTAGT,0,0,0,0,0.00
2,G08---D708-D507--TAATGCGC-CAGGACGT-,TAATGCGCAT-ACGTCCTGGT,0,0,0,0,0.00
2,H08---D708-D508--TAATGCGC-GTACTGAC-,TAATGCGCAT-GTCAGTACGT,0,0,0,0,0.00
2,A09---D709-D501--CGGCTATG-TATAGCCT-,CGGCTATGAT-AGGCTATAGT,0,0,0,0,0.00
2,B09---D709-D502--CGGCTATG-ATAGAGGC-,CGGCTATGAT-GCCTCTATGT,0,0,0,0,0.00
2,C09---D709-D503--CGGCTATG-CCTATCCT-,CGGCTATGAT-AGGATAGGGT,0,0,0,0,0.00
2,D09---D709-D504--CGGCTATG-GGCTCTGA-,CGGCTATGAT-TCAGAGCCGT,0,0,0,0,0.00
2,E09---D709-D505--CGGCTATG-AGGCGAAG-,CGGCTATGAT-CTTCGCCTGT,0,0,0,0,0.00
2,F09---D709-D506--CGGCTATG-TAATCTTA-,CGGCTATGAT-TAAGATTAGT,0,0,0,0,0.00
2,G09---D709-D507--CGGCTATG-CAGGACGT-,CGGCTATGAT-ACGTCCTGGT,0,0,0,0,0.00
2,H09---D709-D508--CGGCTATG-GTACTGAC-,CGGCTATGAT-GTCAGTACGT,0,0,0,0,0.00
2,A10---D710-D501--TCCGCGAA-TATAGCCT-,TCCGCGAAAT-AGGCTATAGT,0,0,0,0,0.00
2,B10---D710-D502--TCCGCGAA-ATAGAGGC-,TCCGCGAAAT-GCCTCTATGT,0,0,0,0,0.00
2,C10---D710-D503--TCCGCGAA-CCTATCCT-,TCCGCGAAAT-AGGATAGGGT,0,0,0,0,0.00
2,D10---D710-D504--TCCGCGAA-GGCTCTGA-,TCCGCGAAAT-TCAGAGCCGT,0,0,0,0,0.00
2,E10---D710-D505--TCCGCGAA-AGGCGAAG-,TCCGCGAAAT-CTTCGCCTGT,0,0,0,0,0.00
2,F10---D710-D506--TCCGCGAA-TAATCTTA-,TCCGCGAAAT-TAAGATTAGT,0,0,0,0,0.00
2,G10---D710-D507--TCCGCGAA-CAGGACGT-,TCCGCGAAAT-ACGTCCTGGT,0,0,0,0,0.00
2,H10---D710-D508--TCCGCGAA-GTACTGAC-,TCCGCGAAAT-GTCAGTACGT,0,0,0,0,0.00
2,A11---D711-D501--TCTCGCGC-TATAGCCT-,TCTCGCGCAT-AGGCTATAGT,0,0,0,0,0.00
2,B11---D711-D502--TCTCGCGC-ATAGAGGC-,TCTCGCGCAT-GCCTCTATGT,0,0,0,0,0.00
2,C11---D711-D503--TCTCGCGC-CCTATCCT-,TCTCGCGCAT-AGGATAGGGT,0,0,0,0,0.00
2,D11---D711-D504--TCTCGCGC-GGCTCTGA-,TCTCGCGCAT-TCAGAGCCGT,0,0,0,0,0.00
2,E11---D711-D505--TCTCGCGC-AGGCGAAG-,TCTCGCGCAT-CTTCGCCTGT,0,0,0,0,0.00
2,F11---D711-D506--TCTCGCGC-TAATCTTA-,TCTCGCGCAT-TAAGATTAGT,0,0,0,0,0.00
2,G11---D711-D507--TCTCGCGC-CAGGACGT-,TCTCGCGCAT-ACGTCCTGGT,0,0,0,0,0.00
2,H11---D711-D508--TCTCGCGC-GTACTGAC-,TCTCGCGCAT-GTCAGTACGT,0,0,0,0,0.00
2,A12---D712-D501--AGCGATAG-TATAGCCT-,AGCGATAGAT-AGGCTATAGT,0,0,0,0,0.00
2,B12---D712-D502--AGCGATAG-ATAGAGGC-,AGCGATAGAT-GCCTCTATGT,0,0,0,0,0.00
2,C12---D712-D503--AGCGATAG-CCTATCCT-,AGCGATAGAT-AGGATAGGGT,0,0,0,0,0.00
2,D12---D712-D504--AGCGATAG-GGCTCTGA-,AGCGATAGAT-TCAGAGCCGT,0,0,0,0,0.00
2,E12---D712-D505--AGCGATAG-AGGCGAAG-,AGCGATAGAT-CTTCGCCTGT,0,0,0,0,0.00
2,F12---D712-D506--AGCGATAG-TAATCTTA-,AGCGATAGAT-TAAGATTAGT,0,0,0,0,0.00
2,G12---D712-D507--AGCGATAG-CAGGACGT-,AGCGATAGAT-ACGTCCTGGT,0,0,0,0,0.00
2,H12---D712-D508--AGCGATAG-GTACTGAC-,AGCGATAGAT-GTCAGTACGT,0,0,0,0,0.00
2,Duplex-primer--6-F1---TTCCAAGG-CCTTGTAG-,TTCCAAGGAT-CTACAAGGGT,0,0,0,0,0.00
2,Duplex-primer--10-B2---ATCGATCG-TGCTTCCA-,ATCGATCGAT-TGGAAGCAGT,0,0,0,0,0.00
2,Duplex-primer--14-F2---TGGACTCT-CCGTAAGA-,TGGACTCTAT-TCTTACGGGT,0,0,0,0,0.00
2,Duplex-primer--4-D1---GAGACGAT-TAACCGGT-,GAGACGATAT-ACCGGTTAGT,0,0,0,0,0.00
2,Duplex-primer--13-E2---TACGCTAC-ATCACACG-,TACGCTACAT-CGTGTGATGT,0,0,0,0,0.00
2,Duplex-primer--7-G1---CGCATGAT-TCAGGCTT-,CGCATGATAT-AAGCCTGAGT,0,0,0,0,0.00
2,Duplex-primer--9-A2---CGGCTAAT-AGAACGAG-,CGGCTAATAT-CTCGTTCTGT,0,0,0,0,0.00
2,Duplex-primer--12-D2---GCTATCCT-CACCTGTT-,GCTATCCTAT-AACAGGTGGT,0,0,0,0,0.00
2,Duplex-primer--1-A1---CTGATCGT-ATATGCGC-,CTGATCGTAT-GCGCATATGT,0,0,0,0,0.00
2,Duplex-primer--15-G2---AGAGTAGC-TACGCCTT-,AGAGTAGCAT-AAGGCGTAGT,0,0,0,0,0.00
2,Duplex-primer--11-C2---GCAAGATC-CTTCGACT-,GCAAGATCAT-AGTCGAAGGT,0,0,0,0,0.00
2,Duplex-primer--2-B1---ACTCTCGA-TGGTACAG-,ACTCTCGAAT-CTGTACCAGT,0,0,0,0,0.00
2,Duplex-primer--3-C1---TGAGCTAG-AACCGTTC-,TGAGCTAGAT-GAACGGTTGT,0,0,0,0,0.00
2,Duplex-primer--8-H1---ACGGAACA-GTTCTCGT-,ACGGAACAAT-ACGAGAACGT,0,0,0,0,0.00
2,Duplex-primer--5-E1---CTTGTCGA-GAACATCG-,CTTGTCGAAT-CGATGTTCGT,0,0,0,0,0.00
2,Duplex-primer--16-H2---ATCCAGAG-CGACGTTA-,ATCCAGAGAT-TAACGTCGGT,0,0,0,0,0.00
2,Undetermined,Undetermined,154612366,154612366,0,38446648106,33.54
3,ACC7880A64,TCAAGTTCCT-CAAGTTCTAG,5419028,5267393,151635,1525055131,35.82
3,ACC7880A83,TCGTGGCTAG-GCCAGCAGTA,5840966,5694352,146614,1623520928,35.58
3,ACC7880A65,AGACCTAGCT-CACAAGTATC,5543431,5423283,120148,1564149067,35.88
3,ACC7880A71,CTGCGTACTC-CTGATGGCAA,6132006,6007938,124068,1718602189,35.74
3,ACC7880A78,CGCAGAACTT-TATCGACGTC,6380947,6230827,150120,1798039267,35.85
3,ACC7880A16,TCGCTTAAGC-CTAGGCGTGT,5794242,5715690,78552,1622109214,35.73
3,ACC7880A70,TTCACACAGT-CTTCAGTGTT,4407892,4333046,74846,1238988765,35.81
3,ACC7880A36,GCTGCCGATA-TATCCTACGT,4899530,4828374,71156,1383399293,35.88
3,ACC7880A72,TGGATATGGC-TGGCGCGTAT,8958864,8804028,154836,2489548532,35.59
3,ACC7880A84,AGGACTGAAC-TGAAGCGACG,7251973,7129325,122648,2035537396,35.78
3,ACC7880A27,TTAGGAGGAA-GAACTTGCGT,5583206,5411491,171715,1545740287,35.52
3,ACC7880A51,GAGCATCCAT-TCACGTCCAC,2195386,2162364,33022,616238111,35.77
3,ACC7880A76,AATGTGGCGT-TGTCAGGTAG,5188007,5094672,93335,1461006994,35.84
3,ACC7880A10,CTAGTCAGAA-TTGAATGCTG,5760210,5650858,109352,1607252741,35.66
3,ACC7880A85,GCTGAGAGCT-GTGATAGGTG,5749316,5545318,203998,1607474844,35.71
3,ACC7880A77,GCTACTGTCG-CTTGCTCCAT,3122530,3054892,67638,865307868,35.52
3,ACC7880A17,AAGACAGCTT-TCGCTGACCT,8030149,7893026,137123,2237208835,35.62
3,ACC7880A80,GTTCCACCGA-CCTGCTGTTA,5212734,5111751,100983,1413537210,34.99
3,ACC7880A59,CGGAACGAAG-ACCATCGCCT,7048735,6870419,178316,1980485113,35.78
3,ACC7880A49,GACGAACGTA-TCGTCCTTCA,6743839,6634661,109178,1835499109,35.18
3,ACC7880A24,GACAATAGAG-TAGTGTACAC,6084734,3809020,2275714,1653336359,35.14
3,ACC7880A63,TCAGCACCGT-ACTGAATAGG,5668284,5565016,103268,1574780870,35.57
3,ACC7880A25,AGACGGCATC-AAGGTAACCT,5410503,5296402,114101,1492224392,35.45
3,ACC7880A87,AATGGTACTG-ACAGCAGTTA,6204166,6069248,134918,1711211246,35.44
3,ACC7880A23,TGCCACTGTA-CAGCAGGTCA,5156600,5053592,103008,1421891380,35.43
3,ACC7880A20,AGCTATCTTC-GTGTCGCTAG,5885140,5742495,142645,1649000835,35.74
3,ACC7880A39,ATACCTGTGA-GCATTGTGCT,3316267,3252917,63350,908194569,35.29
3,ACC7880A33,TTGGCCAGTT-ATGCTACCTG,6682905,6513579,169326,1874494930,35.76
3,ACC7880A9,CGATGAGACT-TTAGTCGTGC,4830631,4735958,94673,1348850504,35.67
3,ACC7880A41,AGAGATGGTA-GCTTACGGAA,2212621,889753,1322868,614573378,35.57
3,ACC7880A67,GCCTAGGACT-GAGAACGGCT,5887166,5769036,118130,1657352714,35.83
3,ACC7880A28,ACAGAAGGTT-TGGAGATATC,6542850,6441364,101486,1842744210,35.84
3,ACC7880A57,ACGCGGACTT-TATTGCCTCG,8279916,8117967,161949,2337821986,35.89
3,ACC7880A32,AACGACGCAT-AACTACAACG,9030414,8893928,136486,2533866891,35.74
3,ACC7880A40,TCAGATTCAC-TGGAGTGCGA,2459187,2403377,55810,686507743,35.67
3,ACC7880A48,CCGACTCCTT-ACTGTCCTTG,1861885,1780271,81614,521009225,35.71
3,ACC7880A44,TCACCGTCAC-CAACTCCTTA,8996585,8841865,154720,2531187430,35.81
3,ACC7880A56,CTATAGCGAG-AGTCGACTAG,5951439,5786405,165034,1668303188,35.76
3,ACC7880A89,TCACCAGGAC-TCCTTGTCTC,7898163,7783898,114265,2200346097,35.61
3,ACC7880A11,CGATAGCAGG-TCGTAGCATT,4643321,4571419,71902,1274923965,35.33
3,ACC7880A68,TTCCACCTGG-ATGAGCTTCT,6928425,6797713,130712,1871018852,35.01
3,ACC7880A3,TGTGAGCGAA-GATCGGAGTT,4595731,4524820,70911,1260187340,35.32
3,ACC7880A74,CTCTCATGCG-ACGTCGGTTG,6039577,5908400,131177,1645604890,35.19
3,ACC7880A18,TATCACTCTC-ACCTTGTTCT,6372055,5932967,439088,1749799147,35.37
3,ACC7880A46,GTGTTATCTC-ACACCAGACT,7486489,7084252,402237,2080167607,35.58
3,ACC7880A38,CTATACACCA-CCAACTACGG,3805587,3719669,85918,1019792626,34.78
3,ACC7880A30,TTCAGGTCGT-TTGGTTGGTT,7831095,7684021,147074,2175013697,35.57
3,ACC7880A22,AGAGGAATCG-CCAGACTATC,5076113,4956180,119933,1399128014,35.42
3,ACC7880A26,ACTGGTGTCG-CAAGTCCTGT,7030158,6881901,148257,1960558750,35.64
3,ACC7880A29,GAGAGCTAAC-CAATACTTGC,6627654,6521154,106500,1853576684,35.70
3,ACC7880A50,CCACTGTGAC-TGGACAGATG,7568923,7420841,148082,2107805062,35.62
3,ACC7880A8,AATCTCAGGC-TCTCTAACTC,1932067,1895006,37061,537577045,35.59
3,ACC7880A58,AGAATCCTTC-TGCCAGGTGT,3602903,3415594,187309,1011401103,35.79
3,ACC7880A21,AGGTGGCTAC-CCACGTAACG,6622962,6519909,103053,1858111497,35.76
3,ACC7880A75,CAACCGATTA-TGCTGAGTTA,5760183,5584337,175846,1604798660,35.63
3,ACC7880A69,TTATCTGTGC-CACTCAGTAT,4397423,4323529,73894,1223365410,35.59
3,ACC7880A90,TAATCTACGG-CTGGCACTTA,6392339,6276460,115879,1772878738,35.54
3,ACC7880A82,GAGCTCCACA-CAGAACAGAA,2691753,2629852,61901,719313692,34.71
3,ACC7880A52,GTTATTAGGC-CTCGATGAAC,3798353,3689047,109306,1060950879,35.69
3,ACC7880A47,AACACAGCCG-AGACCTTGGT,4705423,4610863,94560,1292282349,35.33
3,ACC7880A54,CGCTTAAGTA-ATTACTGCAC,6558272,6440758,117514,1814216852,35.49
3,ACC7880A62,CACGGTTGGT-CTAGCTGAAT,5562796,5450197,112599,1542878123,35.54
3,ACC7880A81,GACGTTCTCT-AGTAGAGCTA,6347952,6159836,188116,1780404979,35.76
3,ACC7880A5,AACAACCTCA-TTGGACTAAG,1155333,1125269,30064,316015633,35.26
3,ACC7880A31,CTTGTCTTGC-AACCAATGTG,4951162,4857078,94084,1375383322,35.57
3,ACC7880A4,GATGAAGGAT-GAATAAGGCT,1287944,1268855,19089,360573821,35.71
3,ACC7880A66,GCCTTACTTA-GCACCTTAAC,4944901,4848112,96789,1386529409,35.75
3,ACC7880A34,ATTGCGGCTG-TGTCCTACAA,6249797,6098188,151609,1746215466,35.67
3,ACC7880A12,TATGGTGATG-TTCAAGTAGC,7228480,7067888,160592,2026353518,35.75
3,ACC7880A14,CCGGTTCATG-AGACGTCTTG,1465511,1416899,48612,400849158,35.30
3,ACC7880A60,TATCGTTGTG-TGTGTCCGCA,6632545,6473798,158747,1860089687,35.76
3,ACC7880A19,GCTGCTAACA-AGCTCTTGTG,4599559,4486175,113384,1283723855,35.67
3,ACC7880A7,ACCGACGTGA-AACGGTCATG,5443333,5336661,106672,1449466113,34.71
3,ACC7880A88,CAGCCTTGAG-TGAGTAGCAT,5696912,4006817,1690095,1570654826,35.41
3,ACC7880A37,GAATGTCCAA-GAATACCGTA,6545479,6391744,153735,1825991183,35.65
3,ACC7880A13,GTTGGACGGT-AGGACACTGT,4180041,4106536,73505,1161557674,35.58
3,ACC7880A45,TGTGAAGCTA-ACGCGATTCA,5898236,5788521,109715,1621492997,35.37
3,ACC7880A53,TTATCGCTGA-TTAGGATTGG,7523876,7380776,143100,2023972018,34.92
3,ACC7880A1,ATTCCACACT-TGGTCTTGTT,3824065,3745196,78869,1054813161,35.45
3,ACC7880A55,TTACGGAACA-TGACTCTGTC,2616076,2570107,45969,727268657,35.58
3,ACC7880A2,TACTAGAGGA-GAACCGGTCT,4099662,4024918,74744,1089126804,34.59
3,ACC7880A61,AACACAACGA-ACGCAGCCAA,7040359,6879646,160713,1904733987,34.95
3,ACC7880A79,CCAAGACACT-ACCGACATGG,2248607,2175383,73224,621855868,35.48
3,ACC7880A86,GAGCTTATGA-ACCAGTCATT,6823010,6712507,110503,1865554563,35.19
3,ACC7880A42,ATGGAGACGG-CTGAGAGTTC,6498440,6386182,112258,1785938969,35.36
3,ACC7880A43,GTGTACGTCG-TCCTAGCAGG,5407464,5312010,95454,1518821737,35.78
3,ACC7880A35,AGAGACTTAC-TAAGAGTTGG,4545774,4461591,84183,1279324085,35.82
3,ACC7880A6,AGATCTTCCA-GTGTTGATCT,2682947,2627826,55121,703978515,34.43
3,ACC7880A15,TTGGCCATAC-GCCTAGTGCA,6403580,6292153,111427,1795257444,35.75
3,ACC7880A73,TATAACTCCG-TATGTGTCCT,6250088,6134266,115822,1740959781,35.62
3,ACC7804A22,GGTCACGAAT-CATAATACGT,36938270,36333453,604817,10189742805,35.47
3,ACC7804A13,AGTACTCCAT-AACAGGTTGT,56929398,55359369,1570029,15716596819,35.49
3,ACC7809A1,TATCGCACAT-ACACTAAGGT,24324918,23555886,769032,6601793604,35.16
3,ACC7795A1,CAACAATGAT-CCGTGAAGGT,292091853,286470735,5621118,80501421174,35.45
3,ACC7804A15,TGCGAGACAT-CAACAATGGT,27834751,27270803,563948,7684318279,35.49
3,ACC7809A2,CGCTATGTAT-GTGTCGGAGT,32054955,30787083,1267872,8623715113,35.00
3,ACC7795A2,TGGTGGCAAT-TTACAGGAGT,117971874,115508479,2463395,32430767694,35.42
3,ACC7804A18,GTATGTTCAT-TTCCTGTTGT,17073392,16340312,733080,4630139267,35.17
3,ACC7807A1,ACGCACCTAT-CCTTCACCGT,17649676,17110963,538713,4752524410,35.05
3,ACC7866A1,CCGCGGTTAT-CTAGCGCTGT,138916393,134182209,4734184,38401112487,35.52
3,ACC7866A9,AGTTCAGGAT-TCTGTTGGGT,95711550,92845748,2865802,26314296631,35.43
3,ACC7872A3,TAATACAGAT-GTGAATATGT,101841394,98935339,2906055,28077487115,35.46
3,ACC7866A2,TTATAACCAT-TCGATATCGT,90907649,89027358,1880291,25068623141,35.47
3,ACC7872A4,CGGCGTGAAT-ACAGGCGCGT,94760332,92078875,2681457,26141635416,35.48
3,ACC7866A3,GGACTTGGAT-CGTCTGCGGT,74030170,72577421,1452749,20421486557,35.48
3,ACC7804A17,TCTCTACTAT-GAACCGCGGT,81046053,68875282,12170771,22239871210,35.38
3,ACC7872A5,ATGTAAGTAT-CATAGAGTGT,104113735,101518773,2594962,28619810317,35.42
3,ACC7866A4,AAGTCCAAAT-TACTCATAGT,98862041,96584249,2277792,27276151809,35.47
3,ACC7872A6,GCACGGACAT-TGCGAGACGT,91329087,89299340,2029747,25212184355,35.49
3,ACC7866A5,ATCCACTGAT-ACGCACCTGT,93591686,90942438,2649248,25750855757,35.43
3,ACC7872A7,GGTACCTTAT-GACGTCTTGT,128156927,124251668,3905259,35413787270,35.50
3,ACC7866A6,GCTTGTCAAT-GTATGTTCGT,81843420,79141059,2702361,22578712710,35.48
3,ACC7872A8,AACGTTCCAT-AGTACTCCGT,84852051,82537731,2314320,23449699834,35.50
3,ACC7866A7,CAAGCTAGAT-CGCTATGTGT,93340316,90891367,2448949,25762275400,35.48
3,ACC7872A9,GCAGAATTAT-TGGCCGGTGT,110099132,107832114,2267018,30445045299,35.52
3,ACC7866A8,TGGATCGAAT-TATCGCACGT,81903756,79930277,1973479,22636714735,35.51
3,ACC7872A2,AATCCGGAAT-AACTGTAGGT,86986398,83491188,3495210,23597882096,35.19
3,C07---UDI0051,AACAGGTTAT-CTTGGTATGT,886,858,28,242899,35.39
3,H06---UDI0048,ACCTTGGCAT-ATGAGGCCGT,661,619,42,182033,35.46
3,B07---UDI0050,GCGCTCTAAT-GTCGGAGCGT,664,649,15,183784,35.54
3,G06---UDI0047,GTTCCAATAT-GCAGAATTGT,829,806,23,228847,35.50
3,C06---UDI0043,AAGATACTAT-ATGTAAGTGT,664,642,22,183370,35.49
3,F06---UDI0046,GCAATGCAAT-AACGTTCCGT,603,587,16,167215,35.58
3,A06---UDI0041,ATATGGATAT-TAATACAGGT,939,922,17,259351,35.50
3,G05---UDI0039,TAAGTGGTAT-GGCTTAAGGT,0,0,0,0,0.00
3,F08---UDI0062,TAAGGTCAAT-CTACGACAGT,712,698,14,196753,35.50
3,B06---UDI0042,GCGCAAGCAT-CGGCGTGAGT,545,526,19,149713,35.41
3,H07---UDI0056,GAATGAGAAT-AATGCCTCGT,704,692,12,194793,35.54
3,H10---UDI0080,GTGAATATAT-GAATGAGAGT,0,0,0,0,0.00
3,G07---UDI0055,AGGCAGAGAT-GGCATTCTGT,640,431,209,176627,35.48
3,G08---UDI0063,TTGCCTAGAT-TAAGTGGTGT,699,684,15,192774,35.50
3,B05---UDI0034,CGTTAGAAAT-GACCTGAAGT,825,804,21,227428,35.45
3,E04---UDI0029,CCGTGAAGAT-ATCCACTGGT,55,52,3,14733,34.98
3,D05---UDI0036,GATTCTGCAT-CTCTCGTCGT,3,3,0,849,35.91
3,C05---UDI0035,AGCCTCATAT-TCTCTACTGT,41,41,0,11292,35.46
3,D04---UDI0028,TCCAACGCAT-AAGTCCAAGT,44,42,2,12383,35.85
3,E08---UDI0061,CGGAACTGAT-TCGTAGTGGT,626,611,15,174313,35.67
3,D08---UDI0060,AGCTCGCTAT-GATTCTGCGT,822,768,54,223921,35.28
3,F05---UDI0038,CTACGACAAT-TTGGACTCGT,6,5,1,1652,35.46
3,A10---UDI0073,CAATTAACAT-ATATCTCGGT,45,40,5,12013,34.91
3,E06---UDI0045,ATGGCATGAT-GGTACCTTGT,721,699,22,197671,35.37
3,A11---UDI0081,AACTGTAGAT-TGCGGCGTGT,40,39,1,10927,35.34
3,D06---UDI0044,GGAGCGTCAT-GCACGGACGT,610,599,11,166837,35.33
3,B10---UDI0074,TGGCCGGTAT-GCGCTCTAGT,0,0,0,0,0.00
3,E05---UDI0037,TCGTAGTGAT-CCAAGTCTGT,3,3,0,822,35.35
3,D07---UDI0052,GGTGAACCAT-TCCAACGCGT,0,0,0,0,0.00
3,A09---UDI0065,ACACTAAGAT-ATATGGATGT,1179,1121,58,324437,35.43
3,C09---UDI0067,TTCCTGTTAT-AAGATACTGT,2,1,1,584,36.49
3,E09---UDI0069,GCCACAGGAT-ATGGCATGGT,0,0,0,0,0.00
3,G10---UDI0079,ACAGGCGCAT-AGGCAGAGGT,1,1,0,294,36.54
3,F04---UDI0030,TTACAGGAAT-GCTTGTCAGT,64,63,1,17095,35.02
3,B09---UDI0066,GTGTCGGAAT-GCGCAAGCGT,1,1,0,265,35.16
3,D10---UDI0076,GACGTCTTAT-GGTGAACCGT,1,1,0,291,36.33
3,E12---UDI0093,TACTCATAAT-GCCACAGGGT,0,0,0,0,0.00
3,F10---UDI0078,CATAGAGTAT-TGGTGGCAGT,2,2,0,523,34.56
3,D09---UDI0068,CCTTCACCAT-GGAGCGTCGT,3,3,0,838,35.67
3,A05---UDI0033,TACCGAGGAT-AGTTCAGGGT,2477,2364,113,682843,35.48
3,A07---UDI0049,ATATCTCGAT-ACTAAGATGT,825,794,31,226612,35.40
3,H08---UDI0064,CCATTCGAAT-CGGACAACGT,5,4,1,1242,33.62
3,G02---UDI0015,GGCTTAAGAT-GGTCACGAGT,153,151,2,42353,35.55
3,F12---UDI0094,CGTCTGCGAT-ATTGTGAAGT,0,0,0,0,0.00
3,H12---UDI0096,CTAGCGCTAT-GTCTACACGT,0,0,0,0,0.00
3,G04---UDI0031,GGCATTCTAT-CAAGCTAGGT,557,532,25,152910,35.42
3,H04---UDI0032,AATGCCTCAT-TGGATCGAGT,1850,1806,44,509524,35.45
3,G12---UDI0095,TCGATATCAT-ACTCGTGTGT,0,0,0,0,0.00
3,E02---UDI0013,CCAAGTCTAT-TCATCCTTGT,43,42,1,11353,34.65
3,F02---UDI0014,TTGGACTCAT-CTGCTTCCGT,0,0,0,0,0.00
3,D02---UDI0012,CTCTCGTCAT-AGGTTATAGT,1,1,0,287,36.31
3,B02---UDI0010,GACCTGAAAT-CTCACCAAGT,0,0,0,0,0.00
3,E11---UDI0085,AGGTTATAAT-CGGAACTGGT,1,1,0,291,36.47
3,D11---UDI0084,TCATCCTTAT-AGCTCGCTGT,0,0,0,0,0.00
3,G11---UDI0087,CTCACCAAAT-TTGCCTAGGT,3,3,0,869,36.37
3,H05---UDI0040,CGGACAACAT-AATCCGGAGT,1,0,1,266,34.92
3,C08---UDI0059,GATCTATCAT-AGCCTCATGT,606,577,29,167746,35.56
3,C11---UDI0083,CTGCTTCCAT-GATCTATCGT,40,39,1,11045,35.48
3,F11---UDI0086,GAACCGCGAT-TAAGGTCAGT,0,0,0,0,0.00
3,C04---UDI0027,CTTGGTATAT-GGACTTGGGT,50,47,3,13300,34.83
3,B04---UDI0026,GTCGGAGCAT-TTATAACCGT,36,35,1,10089,35.79
3,F09---UDI0070,ATTGTGAAAT-GCAATGCAGT,2,2,0,551,35.48
3,G09---UDI0071,ACTCGTGTAT-GTTCCAATGT,1,1,0,286,36.32
3,H09---UDI0072,GTCTACACAT-ACCTTGGCGT,1,1,0,282,36.11
3,A04---UDI0025,ACTAAGATAT-CCGCGGTTGT,32,25,7,8562,35.02
3,B08---UDI0058,CATAATACAT-CGTTAGAAGT,725,711,14,200139,35.50
3,H11---UDI0088,TCTGTTGGAT-CCATTCGAGT,0,0,0,0,0.00
3,H03---UDI0024,ATGAGGCCAT-CAATTAACGT,20,20,0,5585,35.76
3,A08---UDI0057,TGCGGCGTAT-TACCGAGGGT,795,782,13,217600,35.34
3,A01---D701-D501--ATTACTCG-TATAGCCT-,ATTACTCGAT-AGGCTATAGT,0,0,0,0,0.00
3,B01---D701-D502--ATTACTCG-ATAGAGGC-,ATTACTCGAT-GCCTCTATGT,0,0,0,0,0.00
3,C01---D701-D503--ATTACTCG-CCTATCCT-,ATTACTCGAT-AGGATAGGGT,0,0,0,0,0.00
3,D01---D701-D504--ATTACTCG-GGCTCTGA-,ATTACTCGAT-TCAGAGCCGT,0,0,0,0,0.00
3,E01---D701-D505--ATTACTCG-AGGCGAAG-,ATTACTCGAT-CTTCGCCTGT,0,0,0,0,0.00
3,F01---D701-D506--ATTACTCG-TAATCTTA-,ATTACTCGAT-TAAGATTAGT,0,0,0,0,0.00
3,G01---D701-D507--ATTACTCG-CAGGACGT-,ATTACTCGAT-ACGTCCTGGT,0,0,0,0,0.00
3,H01---D701-D508--ATTACTCG-GTACTGAC-,ATTACTCGAT-GTCAGTACGT,0,0,0,0,0.00
3,A02---D702-D501--TCCGGAGA-TATAGCCT-,TCCGGAGAAT-AGGCTATAGT,0,0,0,0,0.00
3,B02---D702-D502--TCCGGAGA-ATAGAGGC-,TCCGGAGAAT-GCCTCTATGT,0,0,0,0,0.00
3,C02---D702-D503--TCCGGAGA-CCTATCCT-,TCCGGAGAAT-AGGATAGGGT,0,0,0,0,0.00
3,D02---D702-D504--TCCGGAGA-GGCTCTGA-,TCCGGAGAAT-TCAGAGCCGT,0,0,0,0,0.00
3,E02---D702-D505--TCCGGAGA-AGGCGAAG-,TCCGGAGAAT-CTTCGCCTGT,0,0,0,0,0.00
3,F02---D702-D506--TCCGGAGA-TAATCTTA-,TCCGGAGAAT-TAAGATTAGT,0,0,0,0,0.00
3,G02---D702-D507--TCCGGAGA-CAGGACGT-,TCCGGAGAAT-ACGTCCTGGT,0,0,0,0,0.00
3,H02---D702-D508--TCCGGAGA-GTACTGAC-,TCCGGAGAAT-GTCAGTACGT,0,0,0,0,0.00
3,A03---D703-D501--CGCTCATT-TATAGCCT-,CGCTCATTAT-AGGCTATAGT,0,0,0,0,0.00
3,B03---D703-D502--CGCTCATT-ATAGAGGC-,CGCTCATTAT-GCCTCTATGT,0,0,0,0,0.00
3,C03---D703-D503--CGCTCATT-CCTATCCT-,CGCTCATTAT-AGGATAGGGT,0,0,0,0,0.00
3,D03---D703-D504--CGCTCATT-GGCTCTGA-,CGCTCATTAT-TCAGAGCCGT,0,0,0,0,0.00
3,E03---D703-D505--CGCTCATT-AGGCGAAG-,CGCTCATTAT-CTTCGCCTGT,0,0,0,0,0.00
3,F03---D703-D506--CGCTCATT-TAATCTTA-,CGCTCATTAT-TAAGATTAGT,0,0,0,0,0.00
3,G03---D703-D507--CGCTCATT-CAGGACGT-,CGCTCATTAT-ACGTCCTGGT,0,0,0,0,0.00
3,H03---D703-D508--CGCTCATT-GTACTGAC-,CGCTCATTAT-GTCAGTACGT,0,0,0,0,0.00
3,A04---D704-D501--GAGATTCC-TATAGCCT-,GAGATTCCAT-AGGCTATAGT,0,0,0,0,0.00
3,B04---D704-D502--GAGATTCC-ATAGAGGC-,GAGATTCCAT-GCCTCTATGT,0,0,0,0,0.00
3,C04---D704-D503--GAGATTCC-CCTATCCT-,GAGATTCCAT-AGGATAGGGT,0,0,0,0,0.00
3,D04---D704-D504--GAGATTCC-GGCTCTGA-,GAGATTCCAT-TCAGAGCCGT,0,0,0,0,0.00
3,E04---D704-D505--GAGATTCC-AGGCGAAG-,GAGATTCCAT-CTTCGCCTGT,0,0,0,0,0.00
3,F04---D704-D506--GAGATTCC-TAATCTTA-,GAGATTCCAT-TAAGATTAGT,0,0,0,0,0.00
3,G04---D704-D507--GAGATTCC-CAGGACGT-,GAGATTCCAT-ACGTCCTGGT,0,0,0,0,0.00
3,H04---D704-D508--GAGATTCC-GTACTGAC-,GAGATTCCAT-GTCAGTACGT,0,0,0,0,0.00
3,A05---D705-D501--ATTCAGAA-TATAGCCT-,ATTCAGAAAT-AGGCTATAGT,0,0,0,0,0.00
3,B05---D705-D502--ATTCAGAA-ATAGAGGC-,ATTCAGAAAT-GCCTCTATGT,0,0,0,0,0.00
3,C05---D705-D503--ATTCAGAA-CCTATCCT-,ATTCAGAAAT-AGGATAGGGT,0,0,0,0,0.00
3,D05---D705-D504--ATTCAGAA-GGCTCTGA-,ATTCAGAAAT-TCAGAGCCGT,0,0,0,0,0.00
3,E05---D705-D505--ATTCAGAA-AGGCGAAG-,ATTCAGAAAT-CTTCGCCTGT,0,0,0,0,0.00
3,F05---D705-D506--ATTCAGAA-TAATCTTA-,ATTCAGAAAT-TAAGATTAGT,0,0,0,0,0.00
3,G05---D705-D507--ATTCAGAA-CAGGACGT-,ATTCAGAAAT-ACGTCCTGGT,0,0,0,0,0.00
3,H05---D705-D508--ATTCAGAA-GTACTGAC-,ATTCAGAAAT-GTCAGTACGT,0,0,0,0,0.00
3,A06---D706-D501--GAATTCGT-TATAGCCT-,GAATTCGTAT-AGGCTATAGT,0,0,0,0,0.00
3,B06---D706-D502--GAATTCGT-ATAGAGGC-,GAATTCGTAT-GCCTCTATGT,0,0,0,0,0.00
3,C06---D706-D503--GAATTCGT-CCTATCCT-,GAATTCGTAT-AGGATAGGGT,0,0,0,0,0.00
3,D06---D706-D504--GAATTCGT-GGCTCTGA-,GAATTCGTAT-TCAGAGCCGT,0,0,0,0,0.00
3,E06---D706-D505--GAATTCGT-AGGCGAAG-,GAATTCGTAT-CTTCGCCTGT,0,0,0,0,0.00
3,F06---D706-D506--GAATTCGT-TAATCTTA-,GAATTCGTAT-TAAGATTAGT,0,0,0,0,0.00
3,G06---D706-D507--GAATTCGT-CAGGACGT-,GAATTCGTAT-ACGTCCTGGT,0,0,0,0,0.00
3,H06---D706-D508--GAATTCGT-GTACTGAC-,GAATTCGTAT-GTCAGTACGT,0,0,0,0,0.00
3,A07---D707-D501--CTGAAGCT-TATAGCCT-,CTGAAGCTAT-AGGCTATAGT,0,0,0,0,0.00
3,B07---D707-D502--CTGAAGCT-ATAGAGGC-,CTGAAGCTAT-GCCTCTATGT,0,0,0,0,0.00
3,C07---D707-D503--CTGAAGCT-CCTATCCT-,CTGAAGCTAT-AGGATAGGGT,0,0,0,0,0.00
3,D07---D707-D504--CTGAAGCT-GGCTCTGA-,CTGAAGCTAT-TCAGAGCCGT,0,0,0,0,0.00
3,E07---D707-D505--CTGAAGCT-AGGCGAAG-,CTGAAGCTAT-CTTCGCCTGT,0,0,0,0,0.00
3,F07---D707-D506--CTGAAGCT-TAATCTTA-,CTGAAGCTAT-TAAGATTAGT,0,0,0,0,0.00
3,G07---D707-D507--CTGAAGCT-CAGGACGT-,CTGAAGCTAT-ACGTCCTGGT,0,0,0,0,0.00
3,H07---D707-D508--CTGAAGCT-GTACTGAC-,CTGAAGCTAT-GTCAGTACGT,0,0,0,0,0.00
3,A08---D708-D501--TAATGCGC-TATAGCCT-,TAATGCGCAT-AGGCTATAGT,0,0,0,0,0.00
3,B08---D708-D502--TAATGCGC-ATAGAGGC-,TAATGCGCAT-GCCTCTATGT,0,0,0,0,0.00
3,C08---D708-D503--TAATGCGC-CCTATCCT-,TAATGCGCAT-AGGATAGGGT,0,0,0,0,0.00
3,D08---D708-D504--TAATGCGC-GGCTCTGA-,TAATGCGCAT-TCAGAGCCGT,0,0,0,0,0.00
3,E08---D708-D505--TAATGCGC-AGGCGAAG-,TAATGCGCAT-CTTCGCCTGT,0,0,0,0,0.00
3,F08---D708-D506--TAATGCGC-TAATCTTA-,TAATGCGCAT-TAAGATTAGT,0,0,0,0,0.00
3,G08---D708-D507--TAATGCGC-CAGGACGT-,TAATGCGCAT-ACGTCCTGGT,0,0,0,0,0.00
3,H08---D708-D508--TAATGCGC-GTACTGAC-,TAATGCGCAT-GTCAGTACGT,0,0,0,0,0.00
3,A09---D709-D501--CGGCTATG-TATAGCCT-,CGGCTATGAT-AGGCTATAGT,0,0,0,0,0.00
3,B09---D709-D502--CGGCTATG-ATAGAGGC-,CGGCTATGAT-GCCTCTATGT,0,0,0,0,0.00
3,C09---D709-D503--CGGCTATG-CCTATCCT-,CGGCTATGAT-AGGATAGGGT,0,0,0,0,0.00
3,D09---D709-D504--CGGCTATG-GGCTCTGA-,CGGCTATGAT-TCAGAGCCGT,0,0,0,0,0.00
3,E09---D709-D505--CGGCTATG-AGGCGAAG-,CGGCTATGAT-CTTCGCCTGT,0,0,0,0,0.00
3,F09---D709-D506--CGGCTATG-TAATCTTA-,CGGCTATGAT-TAAGATTAGT,0,0,0,0,0.00
3,G09---D709-D507--CGGCTATG-CAGGACGT-,CGGCTATGAT-ACGTCCTGGT,0,0,0,0,0.00
3,H09---D709-D508--CGGCTATG-GTACTGAC-,CGGCTATGAT-GTCAGTACGT,0,0,0,0,0.00
3,A10---D710-D501--TCCGCGAA-TATAGCCT-,TCCGCGAAAT-AGGCTATAGT,0,0,0,0,0.00
3,B10---D710-D502--TCCGCGAA-ATAGAGGC-,TCCGCGAAAT-GCCTCTATGT,0,0,0,0,0.00
3,C10---D710-D503--TCCGCGAA-CCTATCCT-,TCCGCGAAAT-AGGATAGGGT,0,0,0,0,0.00
3,D10---D710-D504--TCCGCGAA-GGCTCTGA-,TCCGCGAAAT-TCAGAGCCGT,0,0,0,0,0.00
3,E10---D710-D505--TCCGCGAA-AGGCGAAG-,TCCGCGAAAT-CTTCGCCTGT,0,0,0,0,0.00
3,F10---D710-D506--TCCGCGAA-TAATCTTA-,TCCGCGAAAT-TAAGATTAGT,0,0,0,0,0.00
3,G10---D710-D507--TCCGCGAA-CAGGACGT-,TCCGCGAAAT-ACGTCCTGGT,0,0,0,0,0.00
3,H10---D710-D508--TCCGCGAA-GTACTGAC-,TCCGCGAAAT-GTCAGTACGT,0,0,0,0,0.00
3,A11---D711-D501--TCTCGCGC-TATAGCCT-,TCTCGCGCAT-AGGCTATAGT,0,0,0,0,0.00
3,B11---D711-D502--TCTCGCGC-ATAGAGGC-,TCTCGCGCAT-GCCTCTATGT,0,0,0,0,0.00
3,C11---D711-D503--TCTCGCGC-CCTATCCT-,TCTCGCGCAT-AGGATAGGGT,0,0,0,0,0.00
3,D11---D711-D504--TCTCGCGC-GGCTCTGA-,TCTCGCGCAT-TCAGAGCCGT,0,0,0,0,0.00
3,E11---D711-D505--TCTCGCGC-AGGCGAAG-,TCTCGCGCAT-CTTCGCCTGT,0,0,0,0,0.00
3,F11---D711-D506--TCTCGCGC-TAATCTTA-,TCTCGCGCAT-TAAGATTAGT,0,0,0,0,0.00
3,G11---D711-D507--TCTCGCGC-CAGGACGT-,TCTCGCGCAT-ACGTCCTGGT,0,0,0,0,0.00
3,H11---D711-D508--TCTCGCGC-GTACTGAC-,TCTCGCGCAT-GTCAGTACGT,0,0,0,0,0.00
3,A12---D712-D501--AGCGATAG-TATAGCCT-,AGCGATAGAT-AGGCTATAGT,0,0,0,0,0.00
3,B12---D712-D502--AGCGATAG-ATAGAGGC-,AGCGATAGAT-GCCTCTATGT,0,0,0,0,0.00
3,C12---D712-D503--AGCGATAG-CCTATCCT-,AGCGATAGAT-AGGATAGGGT,0,0,0,0,0.00
3,D12---D712-D504--AGCGATAG-GGCTCTGA-,AGCGATAGAT-TCAGAGCCGT,0,0,0,0,0.00
3,E12---D712-D505--AGCGATAG-AGGCGAAG-,AGCGATAGAT-CTTCGCCTGT,0,0,0,0,0.00
3,F12---D712-D506--AGCGATAG-TAATCTTA-,AGCGATAGAT-TAAGATTAGT,0,0,0,0,0.00
3,G12---D712-D507--AGCGATAG-CAGGACGT-,AGCGATAGAT-ACGTCCTGGT,0,0,0,0,0.00
3,H12---D712-D508--AGCGATAG-GTACTGAC-,AGCGATAGAT-GTCAGTACGT,0,0,0,0,0.00
3,Duplex-primer--6-F1---TTCCAAGG-CCTTGTAG-,TTCCAAGGAT-CTACAAGGGT,0,0,0,0,0.00
3,Duplex-primer--10-B2---ATCGATCG-TGCTTCCA-,ATCGATCGAT-TGGAAGCAGT,0,0,0,0,0.00
3,Duplex-primer--14-F2---TGGACTCT-CCGTAAGA-,TGGACTCTAT-TCTTACGGGT,0,0,0,0,0.00
3,Duplex-primer--4-D1---GAGACGAT-TAACCGGT-,GAGACGATAT-ACCGGTTAGT,0,0,0,0,0.00
3,Duplex-primer--13-E2---TACGCTAC-ATCACACG-,TACGCTACAT-CGTGTGATGT,0,0,0,0,0.00
3,Duplex-primer--7-G1---CGCATGAT-TCAGGCTT-,CGCATGATAT-AAGCCTGAGT,0,0,0,0,0.00
3,Duplex-primer--9-A2---CGGCTAAT-AGAACGAG-,CGGCTAATAT-CTCGTTCTGT,0,0,0,0,0.00
3,Duplex-primer--12-D2---GCTATCCT-CACCTGTT-,GCTATCCTAT-AACAGGTGGT,1,0,1,218,31.95
3,Duplex-primer--1-A1---CTGATCGT-ATATGCGC-,CTGATCGTAT-GCGCATATGT,0,0,0,0,0.00
3,Duplex-primer--15-G2---AGAGTAGC-TACGCCTT-,AGAGTAGCAT-AAGGCGTAGT,0,0,0,0,0.00
3,Duplex-primer--11-C2---GCAAGATC-CTTCGACT-,GCAAGATCAT-AGTCGAAGGT,0,0,0,0,0.00
3,Duplex-primer--2-B1---ACTCTCGA-TGGTACAG-,ACTCTCGAAT-CTGTACCAGT,0,0,0,0,0.00
3,Duplex-primer--3-C1---TGAGCTAG-AACCGTTC-,TGAGCTAGAT-GAACGGTTGT,0,0,0,0,0.00
3,Duplex-primer--8-H1---ACGGAACA-GTTCTCGT-,ACGGAACAAT-ACGAGAACGT,0,0,0,0,0.00
3,Duplex-primer--5-E1---CTTGTCGA-GAACATCG-,CTTGTCGAAT-CGATGTTCGT,0,0,0,0,0.00
3,Duplex-primer--16-H2---ATCCAGAG-CGACGTTA-,ATCCAGAGAT-TAACGTCGGT,0,0,0,0,0.00
3,Undetermined,Undetermined,158551675,158551675,0,39717730784,33.67
4,ACC7880A64,TCAAGTTCCT-CAAGTTCTAG,5432926,5278106,154820,1526657948,35.80
4,ACC7880A83,TCGTGGCTAG-GCCAGCAGTA,5813812,5664983,148829,1613154066,35.55
4,ACC7880A65,AGACCTAGCT-CACAAGTATC,5481092,5361168,119924,1544379665,35.85
4,ACC7880A71,CTGCGTACTC-CTGATGGCAA,6036840,5911637,125203,1688662255,35.70
4,ACC7880A78,CGCAGAACTT-TATCGACGTC,6395793,6242805,152988,1799858781,35.83
4,ACC7880A16,TCGCTTAAGC-CTAGGCGTGT,5673321,5595861,77460,1585400885,35.69
4,ACC7880A70,TTCACACAGT-CTTCAGTGTT,4347093,4271561,75532,1219923584,35.78
4,ACC7880A36,GCTGCCGATA-TATCCTACGT,4857932,4786591,71341,1369371616,35.85
4,ACC7880A72,TGGATATGGC-TGGCGCGTAT,8756401,8601909,154492,2427079861,35.54
4,ACC7880A84,AGGACTGAAC-TGAAGCGACG,7171070,7048397,122673,2008940942,35.74
4,ACC7880A27,TTAGGAGGAA-GAACTTGCGT,5482507,5307010,175497,1512742410,35.46
4,ACC7880A51,GAGCATCCAT-TCACGTCCAC,2243975,2210826,33149,628599003,35.73
4,ACC7880A76,AATGTGGCGT-TGTCAGGTAG,5159412,5063702,95710,1450997538,35.82
4,ACC7880A10,CTAGTCAGAA-TTGAATGCTG,5613662,5504364,109298,1561906517,35.61
4,ACC7880A85,GCTGAGAGCT-GTGATAGGTG,5669506,5468352,201154,1581949640,35.67
4,ACC7880A77,GCTACTGTCG-CTTGCTCCAT,3070547,3003007,67540,848770587,35.47
4,ACC7880A17,AAGACAGCTT-TCGCTGACCT,7948199,7810112,138087,2209572288,35.58
4,ACC7880A80,GTTCCACCGA-CCTGCTGTTA,5094004,4993703,100301,1378627179,34.95
4,ACC7880A59,CGGAACGAAG-ACCATCGCCT,7001326,6820917,180409,1963571067,35.75
4,ACC7880A49,GACGAACGTA-TCGTCCTTCA,6658156,6547206,110950,1806250493,35.11
4,ACC7880A24,GACAATAGAG-TAGTGTACAC,5892517,3684200,2208317,1594388728,35.05
4,ACC7880A63,TCAGCACCGT-ACTGAATAGG,5539684,5434682,105002,1532972599,35.50
4,ACC7880A25,AGACGGCATC-AAGGTAACCT,5273657,5157502,116155,1448798282,35.38
4,ACC7880A87,AATGGTACTG-ACAGCAGTTA,6076055,5941101,134954,1668409439,35.36
4,ACC7880A23,TGCCACTGTA-CAGCAGGTCA,5046176,4942706,103470,1386067990,35.35
4,ACC7880A20,AGCTATCTTC-GTGTCGCTAG,5761365,5617856,143509,1612127940,35.72
4,ACC7880A39,ATACCTGTGA-GCATTGTGCT,3291568,3226417,65151,899582848,35.24
4,ACC7880A33,TTGGCCAGTT-ATGCTACCTG,6670897,6495498,175399,1867953219,35.73
4,ACC7880A9,CGATGAGACT-TTAGTCGTGC,4717314,4624403,92911,1313727907,35.62
4,ACC7880A41,AGAGATGGTA-GCTTACGGAA,2162958,856537,1306421,598777998,35.51
4,ACC7880A67,GCCTAGGACT-GAGAACGGCT,5795192,5678424,116768,1628983701,35.80
4,ACC7880A28,ACAGAAGGTT-TGGAGATATC,6535330,6433454,101876,1837981813,35.82
4,ACC7880A57,ACGCGGACTT-TATTGCCTCG,8236335,8070336,165999,2322450392,35.87
4,ACC7880A32,AACGACGCAT-AACTACAACG,9024489,8887244,137245,2525240924,35.70
4,ACC7880A40,TCAGATTCAC-TGGAGTGCGA,2406982,2351228,55754,670280546,35.62
4,ACC7880A48,CCGACTCCTT-ACTGTCCTTG,1838026,1755719,82307,513027070,35.67
4,ACC7880A44,TCACCGTCAC-CAACTCCTTA,8894811,8736449,158362,2497971778,35.78
4,ACC7880A56,CTATAGCGAG-AGTCGACTAG,5895598,5724847,170751,1649559782,35.72
4,ACC7880A89,TCACCAGGAC-TCCTTGTCTC,7768234,7654377,113857,2159228940,35.57
4,ACC7880A11,CGATAGCAGG-TCGTAGCATT,4524982,4454029,70953,1238437928,35.26
4,ACC7880A68,TTCCACCTGG-ATGAGCTTCT,6760786,6631217,129569,1816876825,34.91
4,ACC7880A3,TGTGAGCGAA-GATCGGAGTT,4465455,4395315,70140,1218859765,35.23
4,ACC7880A74,CTCTCATGCG-ACGTCGGTTG,5919184,5786013,133171,1608179236,35.13
4,ACC7880A18,TATCACTCTC-ACCTTGTTCT,6204745,5782293,422452,1698050131,35.31
4,ACC7880A46,GTGTTATCTC-ACACCAGACT,7331737,6934368,397369,2032181418,35.54
4,ACC7880A38,CTATACACCA-CCAACTACGG,3647076,3563785,83291,972803635,34.68
4,ACC7880A30,TTCAGGTCGT-TTGGTTGGTT,7795381,7638415,156966,2160743478,35.54
4,ACC7880A22,AGAGGAATCG-CCAGACTATC,4934940,4818372,116568,1354720937,35.34
4,ACC7880A26,ACTGGTGTCG-CAAGTCCTGT,7006620,6855306,151314,1948936043,35.60
4,ACC7880A29,GAGAGCTAAC-CAATACTTGC,6608248,6500175,108073,1844001836,35.66
4,ACC7880A50,CCACTGTGAC-TGGACAGATG,7520402,7370844,149558,2090440747,35.59
4,ACC7880A8,AATCTCAGGC-TCTCTAACTC,1864349,1828213,36136,516609532,35.52
4,ACC7880A58,AGAATCCTTC-TGCCAGGTGT,3552282,3367857,184425,995868510,35.77
4,ACC7880A21,AGGTGGCTAC-CCACGTAACG,6534333,6430509,103824,1829534163,35.72
4,ACC7880A75,CAACCGATTA-TGCTGAGTTA,5622251,5448940,173311,1561849470,35.58
4,ACC7880A69,TTATCTGTGC-CACTCAGTAT,4274743,4201482,73261,1184635198,35.53
4,ACC7880A90,TAATCTACGG-CTGGCACTTA,6327823,6209244,118579,1750047361,35.48
4,ACC7880A82,GAGCTCCACA-CAGAACAGAA,2595522,2534782,60740,691042354,34.63
4,ACC7880A52,GTTATTAGGC-CTCGATGAAC,3764558,3653386,111172,1049594826,35.65
4,ACC7880A47,AACACAGCCG-AGACCTTGGT,4613498,4518324,95174,1264163365,35.28
4,ACC7880A54,CGCTTAAGTA-ATTACTGCAC,6282719,6168500,114219,1728873849,35.40
4,ACC7880A62,CACGGTTGGT-CTAGCTGAAT,5369414,5260090,109324,1482109243,35.46
4,ACC7880A81,GACGTTCTCT-AGTAGAGCTA,6232670,6042136,190534,1744443993,35.72
4,ACC7880A5,AACAACCTCA-TTGGACTAAG,1131520,1101213,30307,308553438,35.20
4,ACC7880A31,CTTGTCTTGC-AACCAATGTG,4825296,4730969,94327,1336000410,35.51
4,ACC7880A4,GATGAAGGAT-GAATAAGGCT,1260336,1241536,18800,352069278,35.67
4,ACC7880A66,GCCTTACTTA-GCACCTTAAC,4889508,4792656,96852,1368437484,35.72
4,ACC7880A34,ATTGCGGCTG-TGTCCTACAA,5996445,5844751,151694,1669366161,35.61
4,ACC7880A12,TATGGTGATG-TTCAAGTAGC,7116962,6955374,161588,1990182413,35.71
4,ACC7880A14,CCGGTTCATG-AGACGTCTTG,1416978,1366711,50267,385804040,35.21
4,ACC7880A60,TATCGTTGTG-TGTGTCCGCA,6562104,6399982,162122,1836009161,35.72
4,ACC7880A19,GCTGCTAACA-AGCTCTTGTG,4549093,4432747,116346,1267317661,35.63
4,ACC7880A7,ACCGACGTGA-AACGGTCATG,5279353,5174405,104948,1398183503,34.60
4,ACC7880A88,CAGCCTTGAG-TGAGTAGCAT,5497036,3900098,1596938,1510507535,35.36
4,ACC7880A37,GAATGTCCAA-GAATACCGTA,6484540,6326463,158077,1805425530,35.61
4,ACC7880A13,GTTGGACGGT-AGGACACTGT,4072220,3999773,72447,1127758234,35.52
4,ACC7880A45,TGTGAAGCTA-ACGCGATTCA,5727445,5615393,112052,1568470208,35.30
4,ACC7880A53,TTATCGCTGA-TTAGGATTGG,7256596,7111127,145469,1943343875,34.83
4,ACC7880A1,ATTCCACACT-TGGTCTTGTT,3663292,3584567,78725,1005455658,35.36
4,ACC7880A55,TTACGGAACA-TGACTCTGTC,2609089,2563167,45922,723780806,35.54
4,ACC7880A2,TACTAGAGGA-GAACCGGTCT,3942497,3869135,73362,1043003377,34.51
4,ACC7880A61,AACACAACGA-ACGCAGCCAA,6879888,6718841,161047,1856758783,34.90
4,ACC7880A79,CCAAGACACT-ACCGACATGG,2180350,2109439,70911,600175978,35.40
4,ACC7880A86,GAGCTTATGA-ACCAGTCATT,6665205,6556095,109110,1817825212,35.14
4,ACC7880A42,ATGGAGACGG-CTGAGAGTTC,6323924,6212599,111325,1728988090,35.26
4,ACC7880A43,GTGTACGTCG-TCCTAGCAGG,5353315,5258220,95095,1500907475,35.75
4,ACC7880A35,AGAGACTTAC-TAAGAGTTGG,4457092,4372099,84993,1252568872,35.80
4,ACC7880A6,AGATCTTCCA-GTGTTGATCT,2574622,2521741,52881,673264837,34.35
4,ACC7880A15,TTGGCCATAC-GCCTAGTGCA,6346059,6232166,113893,1775873504,35.72
4,ACC7880A73,TATAACTCCG-TATGTGTCCT,6148000,6030850,117150,1709427499,35.58
4,ACC7804A22,GGTCACGAAT-CATAATACGT,36548419,35941040,607379,10069646384,35.45
4,ACC7804A13,AGTACTCCAT-AACAGGTTGT,57137671,55545124,1592547,15757880866,35.47
4,ACC7809A1,TATCGCACAT-ACACTAAGGT,23272178,22571258,700920,6322620443,35.18
4,ACC7795A1,CAACAATGAT-CCGTGAAGGT,294153857,288432786,5721071,80984995905,35.43
4,ACC7804A15,TGCGAGACAT-CAACAATGGT,27569457,27003921,565536,7601652135,35.46
4,ACC7809A2,CGCTATGTAT-GTGTCGGAGT,31363175,30173863,1189312,8456131064,35.03
4,ACC7795A2,TGGTGGCAAT-TTACAGGAGT,117877421,115377158,2500263,32368260543,35.39
4,ACC7804A18,GTATGTTCAT-TTCCTGTTGT,16268474,15606979,661495,4421356782,35.20
4,ACC7807A1,ACGCACCTAT-CCTTCACCGT,16489158,15997764,491394,4450113222,35.08
4,ACC7866A1,CCGCGGTTAT-CTAGCGCTGT,136271390,131594191,4677199,37638543968,35.50
4,ACC7866A9,AGTTCAGGAT-TCTGTTGGGT,97584002,94512414,3071588,26771215177,35.39
4,ACC7872A3,TAATACAGAT-GTGAATATGT,103379446,100353654,3025792,28475778109,35.44
4,ACC7866A2,TTATAACCAT-TCGATATCGT,91505109,89581474,1923635,25209572500,35.45
4,ACC7872A4,CGGCGTGAAT-ACAGGCGCGT,94453920,91652961,2800959,26027679605,35.46
4,ACC7866A3,GGACTTGGAT-CGTCTGCGGT,75279370,73779523,1499847,20737433152,35.45
4,ACC7804A17,TCTCTACTAT-GAACCGCGGT,81023168,68798818,12224350,22214143083,35.36
4,ACC7872A5,ATGTAAGTAT-CATAGAGTGT,102628176,100009536,2618640,28187305602,35.40
4,ACC7866A4,AAGTCCAAAT-TACTCATAGT,98886432,96595797,2290635,27251420627,35.45
4,ACC7872A6,GCACGGACAT-TGCGAGACGT,90992695,88931061,2061634,25091759858,35.47
4,ACC7866A5,ATCCACTGAT-ACGCACCTGT,93951406,91201710,2749696,25828968292,35.41
4,ACC7872A7,GGTACCTTAT-GACGTCTTGT,123436331,119599229,3837102,34083061503,35.49
4,ACC7866A6,GCTTGTCAAT-GTATGTTCGT,83690737,80873501,2817236,23068626697,35.46
4,ACC7872A8,AACGTTCCAT-AGTACTCCGT,85548021,83142276,2405745,23616364532,35.48
4,ACC7866A7,CAAGCTAGAT-CGCTATGTGT,94808626,92309359,2499267,26142975843,35.46
4,ACC7872A9,GCAGAATTAT-TGGCCGGTGT,108085458,105805908,2279550,29858132917,35.50
4,ACC7866A8,TGGATCGAAT-TATCGCACGT,82782382,80739520,2042862,22850956100,35.49
4,ACC7872A2,AATCCGGAAT-AACTGTAGGT,88246173,84563158,3683015,23937917703,35.18
4,C07---UDI0051,AACAGGTTAT-CTTGGTATGT,901,873,28,247779,35.44
4,H06---UDI0048,ACCTTGGCAT-ATGAGGCCGT,734,667,67,201306,35.38
4,B07---UDI0050,GCGCTCTAAT-GTCGGAGCGT,848,826,22,234924,35.55
4,G06---UDI0047,GTTCCAATAT-GCAGAATTGT,840,814,26,231942,35.51
4,C06---UDI0043,AAGATACTAT-ATGTAAGTGT,753,734,19,208939,35.56
4,F06---UDI0046,GCAATGCAAT-AACGTTCCGT,686,667,19,189926,35.56
4,A06---UDI0041,ATATGGATAT-TAATACAGGT,956,935,21,266252,35.65
4,G05---UDI0039,TAAGTGGTAT-GGCTTAAGGT,0,0,0,0,0.00
4,F08---UDI0062,TAAGGTCAAT-CTACGACAGT,745,728,17,202859,35.25
4,B06---UDI0042,GCGCAAGCAT-CGGCGTGAGT,709,687,22,194322,35.37
4,H07---UDI0056,GAATGAGAAT-AATGCCTCGT,798,783,15,220555,35.51
4,H10---UDI0080,GTGAATATAT-GAATGAGAGT,0,0,0,0,0.00
4,G07---UDI0055,AGGCAGAGAT-GGCATTCTGT,715,474,241,198538,35.60
4,G08---UDI0063,TTGCCTAGAT-TAAGTGGTGT,762,748,14,210176,35.48
4,B05---UDI0034,CGTTAGAAAT-GACCTGAAGT,877,851,26,241311,35.43
4,E04---UDI0029,CCGTGAAGAT-ATCCACTGGT,27,25,2,7312,35.13
4,D05---UDI0036,GATTCTGCAT-CTCTCGTCGT,2,2,0,575,36.12
4,C05---UDI0035,AGCCTCATAT-TCTCTACTGT,24,23,1,6462,35.00
4,D04---UDI0028,TCCAACGCAT-AAGTCCAAGT,22,21,1,5909,35.05
4,E08---UDI0061,CGGAACTGAT-TCGTAGTGGT,673,658,15,185315,35.44
4,D08---UDI0060,AGCTCGCTAT-GATTCTGCGT,864,809,55,236949,35.39
4,F05---UDI0038,CTACGACAAT-TTGGACTCGT,0,0,0,0,0.00
4,A10---UDI0073,CAATTAACAT-ATATCTCGGT,33,29,4,8959,35.13
4,E06---UDI0045,ATGGCATGAT-GGTACCTTGT,720,700,20,198086,35.43
4,A11---UDI0081,AACTGTAGAT-TGCGGCGTGT,30,29,1,8312,35.61
4,D06---UDI0044,GGAGCGTCAT-GCACGGACGT,724,703,21,199992,35.53
4,B10---UDI0074,TGGCCGGTAT-GCGCTCTAGT,1,1,0,283,35.97
4,E05---UDI0037,TCGTAGTGAT-CCAAGTCTGT,1,1,0,299,36.83
4,D07---UDI0052,GGTGAACCAT-TCCAACGCGT,0,0,0,0,0.00
4,A09---UDI0065,ACACTAAGAT-ATATGGATGT,1228,1179,49,339298,35.51
4,C09---UDI0067,TTCCTGTTAT-AAGATACTGT,1,1,0,278,35.63
4,E09---UDI0069,GCCACAGGAT-ATGGCATGGT,0,0,0,0,0.00
4,G10---UDI0079,ACAGGCGCAT-AGGCAGAGGT,0,0,0,0,0.00
4,F04---UDI0030,TTACAGGAAT-GCTTGTCAGT,46,44,2,12116,34.66
4,B09---UDI0066,GTGTCGGAAT-GCGCAAGCGT,2,2,0,574,36.17
4,D10---UDI0076,GACGTCTTAT-GGTGAACCGT,1,0,1,178,28.69
4,E12---UDI0093,TACTCATAAT-GCCACAGGGT,0,0,0,0,0.00
4,F10---UDI0078,CATAGAGTAT-TGGTGGCAGT,0,0,0,0,0.00
4,D09---UDI0068,CCTTCACCAT-GGAGCGTCGT,0,0,0,0,0.00
4,A05---UDI0033,TACCGAGGAT-AGTTCAGGGT,2730,2591,139,750874,35.42
4,A07---UDI0049,ATATCTCGAT-ACTAAGATGT,843,812,31,230791,35.33
4,H08---UDI0064,CCATTCGAAT-CGGACAACGT,1,1,0,286,36.13
4,G02---UDI0015,GGCTTAAGAT-GGTCACGAGT,148,146,2,41029,35.59
4,F12---UDI0094,CGTCTGCGAT-ATTGTGAAGT,0,0,0,0,0.00
4,H12---UDI0096,CTAGCGCTAT-GTCTACACGT,0,0,0,0,0.00
4,G04---UDI0031,GGCATTCTAT-CAAGCTAGGT,681,653,28,186383,35.36
4,H04---UDI0032,AATGCCTCAT-TGGATCGAGT,2141,2086,55,589325,35.43
4,G12---UDI0095,TCGATATCAT-ACTCGTGTGT,0,0,0,0,0.00
4,E02---UDI0013,CCAAGTCTAT-TCATCCTTGT,30,30,0,8245,35.50
4,F02---UDI0014,TTGGACTCAT-CTGCTTCCGT,0,0,0,0,0.00
4,D02---UDI0012,CTCTCGTCAT-AGGTTATAGT,0,0,0,0,0.00
4,B02---UDI0010,GACCTGAAAT-CTCACCAAGT,0,0,0,0,0.00
4,E11---UDI0085,AGGTTATAAT-CGGAACTGGT,0,0,0,0,0.00
4,D11---UDI0084,TCATCCTTAT-AGCTCGCTGT,3,3,0,798,34.70
4,G11---UDI0087,CTCACCAAAT-TTGCCTAGGT,5,5,0,1458,36.52
4,H05---UDI0040,CGGACAACAT-AATCCGGAGT,0,0,0,0,0.00
4,C08---UDI0059,GATCTATCAT-AGCCTCATGT,656,625,31,182295,35.62
4,C11---UDI0083,CTGCTTCCAT-GATCTATCGT,26,24,2,7254,35.72
4,F11---UDI0086,GAACCGCGAT-TAAGGTCAGT,0,0,0,0,0.00
4,C04---UDI0027,CTTGGTATAT-GGACTTGGGT,28,28,0,7596,35.24
4,B04---UDI0026,GTCGGAGCAT-TTATAACCGT,21,19,2,5925,35.90
4,F09---UDI0070,ATTGTGAAAT-GCAATGCAGT,1,1,0,197,29.95
4,G09---UDI0071,ACTCGTGTAT-GTTCCAATGT,2,2,0,566,36.04
4,H09---UDI0072,GTCTACACAT-ACCTTGGCGT,0,0,0,0,0.00
4,A04---UDI0025,ACTAAGATAT-CCGCGGTTGT,41,37,4,11013,35.06
4,B08---UDI0058,CATAATACAT-CGTTAGAAGT,803,791,12,223273,35.63
4,H11---UDI0088,TCTGTTGGAT-CCATTCGAGT,0,0,0,0,0.00
4,H03---UDI0024,ATGAGGCCAT-CAATTAACGT,14,12,2,3898,35.65
4,A08---UDI0057,TGCGGCGTAT-TACCGAGGGT,977,948,29,266956,35.30
4,A01---D701-D501--ATTACTCG-TATAGCCT-,ATTACTCGAT-AGGCTATAGT,0,0,0,0,0.00
4,B01---D701-D502--ATTACTCG-ATAGAGGC-,ATTACTCGAT-GCCTCTATGT,0,0,0,0,0.00
4,C01---D701-D503--ATTACTCG-CCTATCCT-,ATTACTCGAT-AGGATAGGGT,0,0,0,0,0.00
4,D01---D701-D504--ATTACTCG-GGCTCTGA-,ATTACTCGAT-TCAGAGCCGT,0,0,0,0,0.00
4,E01---D701-D505--ATTACTCG-AGGCGAAG-,ATTACTCGAT-CTTCGCCTGT,0,0,0,0,0.00
4,F01---D701-D506--ATTACTCG-TAATCTTA-,ATTACTCGAT-TAAGATTAGT,1,0,1,146,26.03
4,G01---D701-D507--ATTACTCG-CAGGACGT-,ATTACTCGAT-ACGTCCTGGT,0,0,0,0,0.00
4,H01---D701-D508--ATTACTCG-GTACTGAC-,ATTACTCGAT-GTCAGTACGT,0,0,0,0,0.00
4,A02---D702-D501--TCCGGAGA-TATAGCCT-,TCCGGAGAAT-AGGCTATAGT,0,0,0,0,0.00
4,B02---D702-D502--TCCGGAGA-ATAGAGGC-,TCCGGAGAAT-GCCTCTATGT,0,0,0,0,0.00
4,C02---D702-D503--TCCGGAGA-CCTATCCT-,TCCGGAGAAT-AGGATAGGGT,0,0,0,0,0.00
4,D02---D702-D504--TCCGGAGA-GGCTCTGA-,TCCGGAGAAT-TCAGAGCCGT,0,0,0,0,0.00
4,E02---D702-D505--TCCGGAGA-AGGCGAAG-,TCCGGAGAAT-CTTCGCCTGT,0,0,0,0,0.00
4,F02---D702-D506--TCCGGAGA-TAATCTTA-,TCCGGAGAAT-TAAGATTAGT,0,0,0,0,0.00
4,G02---D702-D507--TCCGGAGA-CAGGACGT-,TCCGGAGAAT-ACGTCCTGGT,0,0,0,0,0.00
4,H02---D702-D508--TCCGGAGA-GTACTGAC-,TCCGGAGAAT-GTCAGTACGT,0,0,0,0,0.00
4,A03---D703-D501--CGCTCATT-TATAGCCT-,CGCTCATTAT-AGGCTATAGT,0,0,0,0,0.00
4,B03---D703-D502--CGCTCATT-ATAGAGGC-,CGCTCATTAT-GCCTCTATGT,0,0,0,0,0.00
4,C03---D703-D503--CGCTCATT-CCTATCCT-,CGCTCATTAT-AGGATAGGGT,0,0,0,0,0.00
4,D03---D703-D504--CGCTCATT-GGCTCTGA-,CGCTCATTAT-TCAGAGCCGT,0,0,0,0,0.00
4,E03---D703-D505--CGCTCATT-AGGCGAAG-,CGCTCATTAT-CTTCGCCTGT,0,0,0,0,0.00
4,F03---D703-D506--CGCTCATT-TAATCTTA-,CGCTCATTAT-TAAGATTAGT,0,0,0,0,0.00
4,G03---D703-D507--CGCTCATT-CAGGACGT-,CGCTCATTAT-ACGTCCTGGT,0,0,0,0,0.00
4,H03---D703-D508--CGCTCATT-GTACTGAC-,CGCTCATTAT-GTCAGTACGT,0,0,0,0,0.00
4,A04---D704-D501--GAGATTCC-TATAGCCT-,GAGATTCCAT-AGGCTATAGT,0,0,0,0,0.00
4,B04---D704-D502--GAGATTCC-ATAGAGGC-,GAGATTCCAT-GCCTCTATGT,0,0,0,0,0.00
4,C04---D704-D503--GAGATTCC-CCTATCCT-,GAGATTCCAT-AGGATAGGGT,0,0,0,0,0.00
4,D04---D704-D504--GAGATTCC-GGCTCTGA-,GAGATTCCAT-TCAGAGCCGT,0,0,0,0,0.00
4,E04---D704-D505--GAGATTCC-AGGCGAAG-,GAGATTCCAT-CTTCGCCTGT,0,0,0,0,0.00
4,F04---D704-D506--GAGATTCC-TAATCTTA-,GAGATTCCAT-TAAGATTAGT,0,0,0,0,0.00
4,G04---D704-D507--GAGATTCC-CAGGACGT-,GAGATTCCAT-ACGTCCTGGT,0,0,0,0,0.00
4,H04---D704-D508--GAGATTCC-GTACTGAC-,GAGATTCCAT-GTCAGTACGT,0,0,0,0,0.00
4,A05---D705-D501--ATTCAGAA-TATAGCCT-,ATTCAGAAAT-AGGCTATAGT,0,0,0,0,0.00
4,B05---D705-D502--ATTCAGAA-ATAGAGGC-,ATTCAGAAAT-GCCTCTATGT,0,0,0,0,0.00
4,C05---D705-D503--ATTCAGAA-CCTATCCT-,ATTCAGAAAT-AGGATAGGGT,0,0,0,0,0.00
4,D05---D705-D504--ATTCAGAA-GGCTCTGA-,ATTCAGAAAT-TCAGAGCCGT,0,0,0,0,0.00
4,E05---D705-D505--ATTCAGAA-AGGCGAAG-,ATTCAGAAAT-CTTCGCCTGT,0,0,0,0,0.00
4,F05---D705-D506--ATTCAGAA-TAATCTTA-,ATTCAGAAAT-TAAGATTAGT,0,0,0,0,0.00
4,G05---D705-D507--ATTCAGAA-CAGGACGT-,ATTCAGAAAT-ACGTCCTGGT,0,0,0,0,0.00
4,H05---D705-D508--ATTCAGAA-GTACTGAC-,ATTCAGAAAT-GTCAGTACGT,0,0,0,0,0.00
4,A06---D706-D501--GAATTCGT-TATAGCCT-,GAATTCGTAT-AGGCTATAGT,0,0,0,0,0.00
4,B06---D706-D502--GAATTCGT-ATAGAGGC-,GAATTCGTAT-GCCTCTATGT,0,0,0,0,0.00
4,C06---D706-D503--GAATTCGT-CCTATCCT-,GAATTCGTAT-AGGATAGGGT,0,0,0,0,0.00
4,D06---D706-D504--GAATTCGT-GGCTCTGA-,GAATTCGTAT-TCAGAGCCGT,0,0,0,0,0.00
4,E06---D706-D505--GAATTCGT-AGGCGAAG-,GAATTCGTAT-CTTCGCCTGT,0,0,0,0,0.00
4,F06---D706-D506--GAATTCGT-TAATCTTA-,GAATTCGTAT-TAAGATTAGT,0,0,0,0,0.00
4,G06---D706-D507--GAATTCGT-CAGGACGT-,GAATTCGTAT-ACGTCCTGGT,0,0,0,0,0.00
4,H06---D706-D508--GAATTCGT-GTACTGAC-,GAATTCGTAT-GTCAGTACGT,0,0,0,0,0.00
4,A07---D707-D501--CTGAAGCT-TATAGCCT-,CTGAAGCTAT-AGGCTATAGT,0,0,0,0,0.00
4,B07---D707-D502--CTGAAGCT-ATAGAGGC-,CTGAAGCTAT-GCCTCTATGT,0,0,0,0,0.00
4,C07---D707-D503--CTGAAGCT-CCTATCCT-,CTGAAGCTAT-AGGATAGGGT,0,0,0,0,0.00
4,D07---D707-D504--CTGAAGCT-GGCTCTGA-,CTGAAGCTAT-TCAGAGCCGT,0,0,0,0,0.00
4,E07---D707-D505--CTGAAGCT-AGGCGAAG-,CTGAAGCTAT-CTTCGCCTGT,0,0,0,0,0.00
4,F07---D707-D506--CTGAAGCT-TAATCTTA-,CTGAAGCTAT-TAAGATTAGT,0,0,0,0,0.00
4,G07---D707-D507--CTGAAGCT-CAGGACGT-,CTGAAGCTAT-ACGTCCTGGT,0,0,0,0,0.00
4,H07---D707-D508--CTGAAGCT-GTACTGAC-,CTGAAGCTAT-GTCAGTACGT,0,0,0,0,0.00
4,A08---D708-D501--TAATGCGC-TATAGCCT-,TAATGCGCAT-AGGCTATAGT,0,0,0,0,0.00
4,B08---D708-D502--TAATGCGC-ATAGAGGC-,TAATGCGCAT-GCCTCTATGT,0,0,0,0,0.00
4,C08---D708-D503--TAATGCGC-CCTATCCT-,TAATGCGCAT-AGGATAGGGT,0,0,0,0,0.00
4,D08---D708-D504--TAATGCGC-GGCTCTGA-,TAATGCGCAT-TCAGAGCCGT,0,0,0,0,0.00
4,E08---D708-D505--TAATGCGC-AGGCGAAG-,TAATGCGCAT-CTTCGCCTGT,0,0,0,0,0.00
4,F08---D708-D506--TAATGCGC-TAATCTTA-,TAATGCGCAT-TAAGATTAGT,0,0,0,0,0.00
4,G08---D708-D507--TAATGCGC-CAGGACGT-,TAATGCGCAT-ACGTCCTGGT,0,0,0,0,0.00
4,H08---D708-D508--TAATGCGC-GTACTGAC-,TAATGCGCAT-GTCAGTACGT,0,0,0,0,0.00
4,A09---D709-D501--CGGCTATG-TATAGCCT-,CGGCTATGAT-AGGCTATAGT,0,0,0,0,0.00
4,B09---D709-D502--CGGCTATG-ATAGAGGC-,CGGCTATGAT-GCCTCTATGT,0,0,0,0,0.00
4,C09---D709-D503--CGGCTATG-CCTATCCT-,CGGCTATGAT-AGGATAGGGT,0,0,0,0,0.00
4,D09---D709-D504--CGGCTATG-GGCTCTGA-,CGGCTATGAT-TCAGAGCCGT,0,0,0,0,0.00
4,E09---D709-D505--CGGCTATG-AGGCGAAG-,CGGCTATGAT-CTTCGCCTGT,0,0,0,0,0.00
4,F09---D709-D506--CGGCTATG-TAATCTTA-,CGGCTATGAT-TAAGATTAGT,1,0,1,142,26.01
4,G09---D709-D507--CGGCTATG-CAGGACGT-,CGGCTATGAT-ACGTCCTGGT,0,0,0,0,0.00
4,H09---D709-D508--CGGCTATG-GTACTGAC-,CGGCTATGAT-GTCAGTACGT,0,0,0,0,0.00
4,A10---D710-D501--TCCGCGAA-TATAGCCT-,TCCGCGAAAT-AGGCTATAGT,0,0,0,0,0.00
4,B10---D710-D502--TCCGCGAA-ATAGAGGC-,TCCGCGAAAT-GCCTCTATGT,0,0,0,0,0.00
4,C10---D710-D503--TCCGCGAA-CCTATCCT-,TCCGCGAAAT-AGGATAGGGT,0,0,0,0,0.00
4,D10---D710-D504--TCCGCGAA-GGCTCTGA-,TCCGCGAAAT-TCAGAGCCGT,0,0,0,0,0.00
4,E10---D710-D505--TCCGCGAA-AGGCGAAG-,TCCGCGAAAT-CTTCGCCTGT,0,0,0,0,0.00
4,F10---D710-D506--TCCGCGAA-TAATCTTA-,TCCGCGAAAT-TAAGATTAGT,0,0,0,0,0.00
4,G10---D710-D507--TCCGCGAA-CAGGACGT-,TCCGCGAAAT-ACGTCCTGGT,0,0,0,0,0.00
4,H10---D710-D508--TCCGCGAA-GTACTGAC-,TCCGCGAAAT-GTCAGTACGT,0,0,0,0,0.00
4,A11---D711-D501--TCTCGCGC-TATAGCCT-,TCTCGCGCAT-AGGCTATAGT,0,0,0,0,0.00
4,B11---D711-D502--TCTCGCGC-ATAGAGGC-,TCTCGCGCAT-GCCTCTATGT,0,0,0,0,0.00
4,C11---D711-D503--TCTCGCGC-CCTATCCT-,TCTCGCGCAT-AGGATAGGGT,0,0,0,0,0.00
4,D11---D711-D504--TCTCGCGC-GGCTCTGA-,TCTCGCGCAT-TCAGAGCCGT,0,0,0,0,0.00
4,E11---D711-D505--TCTCGCGC-AGGCGAAG-,TCTCGCGCAT-CTTCGCCTGT,0,0,0,0,0.00
4,F11---D711-D506--TCTCGCGC-TAATCTTA-,TCTCGCGCAT-TAAGATTAGT,0,0,0,0,0.00
4,G11---D711-D507--TCTCGCGC-CAGGACGT-,TCTCGCGCAT-ACGTCCTGGT,0,0,0,0,0.00
4,H11---D711-D508--TCTCGCGC-GTACTGAC-,TCTCGCGCAT-GTCAGTACGT,0,0,0,0,0.00
4,A12---D712-D501--AGCGATAG-TATAGCCT-,AGCGATAGAT-AGGCTATAGT,0,0,0,0,0.00
4,B12---D712-D502--AGCGATAG-ATAGAGGC-,AGCGATAGAT-GCCTCTATGT,0,0,0,0,0.00
4,C12---D712-D503--AGCGATAG-CCTATCCT-,AGCGATAGAT-AGGATAGGGT,0,0,0,0,0.00
4,D12---D712-D504--AGCGATAG-GGCTCTGA-,AGCGATAGAT-TCAGAGCCGT,0,0,0,0,0.00
4,E12---D712-D505--AGCGATAG-AGGCGAAG-,AGCGATAGAT-CTTCGCCTGT,0,0,0,0,0.00
4,F12---D712-D506--AGCGATAG-TAATCTTA-,AGCGATAGAT-TAAGATTAGT,0,0,0,0,0.00
4,G12---D712-D507--AGCGATAG-CAGGACGT-,AGCGATAGAT-ACGTCCTGGT,0,0,0,0,0.00
4,H12---D712-D508--AGCGATAG-GTACTGAC-,AGCGATAGAT-GTCAGTACGT,0,0,0,0,0.00
4,Duplex-primer--6-F1---TTCCAAGG-CCTTGTAG-,TTCCAAGGAT-CTACAAGGGT,0,0,0,0,0.00
4,Duplex-primer--10-B2---ATCGATCG-TGCTTCCA-,ATCGATCGAT-TGGAAGCAGT,0,0,0,0,0.00
4,Duplex-primer--14-F2---TGGACTCT-CCGTAAGA-,TGGACTCTAT-TCTTACGGGT,0,0,0,0,0.00
4,Duplex-primer--4-D1---GAGACGAT-TAACCGGT-,GAGACGATAT-ACCGGTTAGT,0,0,0,0,0.00
4,Duplex-primer--13-E2---TACGCTAC-ATCACACG-,TACGCTACAT-CGTGTGATGT,0,0,0,0,0.00
4,Duplex-primer--7-G1---CGCATGAT-TCAGGCTT-,CGCATGATAT-AAGCCTGAGT,0,0,0,0,0.00
4,Duplex-primer--9-A2---CGGCTAAT-AGAACGAG-,CGGCTAATAT-CTCGTTCTGT,0,0,0,0,0.00
4,Duplex-primer--12-D2---GCTATCCT-CACCTGTT-,GCTATCCTAT-AACAGGTGGT,1,0,1,243,33.73
4,Duplex-primer--1-A1---CTGATCGT-ATATGCGC-,CTGATCGTAT-GCGCATATGT,0,0,0,0,0.00
4,Duplex-primer--15-G2---AGAGTAGC-TACGCCTT-,AGAGTAGCAT-AAGGCGTAGT,0,0,0,0,0.00
4,Duplex-primer--11-C2---GCAAGATC-CTTCGACT-,GCAAGATCAT-AGTCGAAGGT,0,0,0,0,0.00
4,Duplex-primer--2-B1---ACTCTCGA-TGGTACAG-,ACTCTCGAAT-CTGTACCAGT,0,0,0,0,0.00
4,Duplex-primer--3-C1---TGAGCTAG-AACCGTTC-,TGAGCTAGAT-GAACGGTTGT,0,0,0,0,0.00
4,Duplex-primer--8-H1---ACGGAACA-GTTCTCGT-,ACGGAACAAT-ACGAGAACGT,0,0,0,0,0.00
4,Duplex-primer--5-E1---CTTGTCGA-GAACATCG-,CTTGTCGAAT-CGATGTTCGT,0,0,0,0,0.00
4,Duplex-primer--16-H2---ATCCAGAG-CGACGTTA-,ATCCAGAGAT-TAACGTCGGT,0,0,0,0,0.00
4,Undetermined,Undetermined,153725089,153725089,0,38165012586,33.51
